"lemma","count_final","rate_final","count_all","rate_all","vs_all","count_not_final","rate_not_final","vs_not_final","diff_rates"
"delit",24,0.00120663650075415,24,0.000200499578115471,119701,0,0,99811,Inf
"dangier",21,0.00105580693815988,21,0.000175437130851037,119701,0,0,99811,Inf
"delivre",18,0.000904977375565611,18,0.000150374683586603,119701,0,0,99811,Inf
"sené",12,0.000603318250377074,12,0.000100249789057736,119701,0,0,99811,Inf
"toucher",12,0.000603318250377074,12,0.000100249789057736,119701,0,0,99811,Inf
"Germain",11,0.000553041729512318,11,9.18956399695909e-05,119701,0,0,99811,Inf
"venger",11,0.000553041729512318,11,9.18956399695909e-05,119701,0,0,99811,Inf
"contredit",10,0.000502765208647562,10,8.35414908814463e-05,119701,0,0,99811,Inf
"reconforter",10,0.000502765208647562,10,8.35414908814463e-05,119701,0,0,99811,Inf
"entier",22,0.00110608345902464,23,0.000192145429027326,119701,1,1.00189357886405e-05,99811,110.399296128708
"apercevoir",35,0.00175967823026647,37,0.000309103516261351,119701,2,2.00378715772811e-05,99811,87.8176219205631
"deviser",14,0.000703871292106586,15,0.000125312236322169,119701,1,1.00189357886405e-05,99811,70.2540975364505
"sovenir",12,0.000603318250377074,13,0.00010860393814588,119701,1,1.00189357886405e-05,99811,60.2177978883861
"prover",22,0.00110608345902464,24,0.000200499578115471,119701,2,2.00378715772811e-05,99811,55.1996480643539
"apareillier",11,0.000553041729512318,12,0.000100249789057736,119701,1,1.00189357886405e-05,99811,55.1996480643539
"consentir",11,0.000553041729512318,12,0.000100249789057736,119701,1,1.00189357886405e-05,99811,55.1996480643539
"demaintenant",11,0.000553041729512318,12,0.000100249789057736,119701,1,1.00189357886405e-05,99811,55.1996480643539
"desvoiier",11,0.000553041729512318,12,0.000100249789057736,119701,1,1.00189357886405e-05,99811,55.1996480643539
"doloir",11,0.000553041729512318,12,0.000100249789057736,119701,1,1.00189357886405e-05,99811,55.1996480643539
"droiture",11,0.000553041729512318,12,0.000100249789057736,119701,1,1.00189357886405e-05,99811,55.1996480643539
"esperdre",10,0.000502765208647562,11,9.18956399695909e-05,119701,1,1.00189357886405e-05,99811,50.1814982403218
"pener",10,0.000502765208647562,11,9.18956399695909e-05,119701,1,1.00189357886405e-05,99811,50.1814982403218
"place",10,0.000502765208647562,11,9.18956399695909e-05,119701,1,1.00189357886405e-05,99811,50.1814982403218
"prouver",10,0.000502765208647562,11,9.18956399695909e-05,119701,1,1.00189357886405e-05,99811,50.1814982403218
"vermeil",10,0.000502765208647562,11,9.18956399695909e-05,119701,1,1.00189357886405e-05,99811,50.1814982403218
"assener",18,0.000904977375565611,20,0.000167082981762893,119701,2,2.00378715772811e-05,99811,45.1633484162896
"découvrir",9,0.000452488687782805,10,8.35414908814463e-05,119701,1,1.00189357886405e-05,99811,45.1633484162896
"hontos",9,0.000452488687782805,10,8.35414908814463e-05,119701,1,1.00189357886405e-05,99811,45.1633484162896
"rage",9,0.000452488687782805,10,8.35414908814463e-05,119701,1,1.00189357886405e-05,99811,45.1633484162896
"repos",9,0.000452488687782805,10,8.35414908814463e-05,119701,1,1.00189357886405e-05,99811,45.1633484162896
"saison",9,0.000452488687782805,10,8.35414908814463e-05,119701,1,1.00189357886405e-05,99811,45.1633484162896
"commandement",17,0.000854700854700855,19,0.000158728832674748,119701,2,2.00378715772811e-05,99811,42.6542735042735
"entremetre",17,0.000854700854700855,19,0.000158728832674748,119701,2,2.00378715772811e-05,99811,42.6542735042735
"decevoir",38,0.00191050779286073,43,0.000359228410790219,119701,5,5.00946789432027e-05,99811,38.1379386626445
"cointe",15,0.000754147812971342,17,0.000142020534498459,119701,2,2.00378715772811e-05,99811,37.6361236802413
"esprendre",13,0.00065359477124183,15,0.000125312236322169,119701,2,2.00378715772811e-05,99811,32.6179738562091
"ennuyer",19,0.000955253896430367,22,0.000183791279939182,119701,3,3.00568073659216e-05,99811,31.7816155522038
"alëure",12,0.000603318250377074,14,0.000116958087234025,119701,2,2.00378715772811e-05,99811,30.1088989441931
"volonté",12,0.000603318250377074,14,0.000116958087234025,119701,2,2.00378715772811e-05,99811,30.1088989441931
"manière",22,0.00110608345902464,26,0.00021720787629176,119701,4,4.00757431545621e-05,99811,27.599824032177
"desfermer",11,0.000553041729512318,13,0.00010860393814588,119701,2,2.00378715772811e-05,99811,27.599824032177
"retraire",26,0.00130718954248366,31,0.000258978621732483,119701,5,5.00946789432027e-05,99811,26.0943790849673
"desservir",10,0.000502765208647562,12,0.000100249789057736,119701,2,2.00378715772811e-05,99811,25.0907491201609
"plaid",10,0.000502765208647562,12,0.000100249789057736,119701,2,2.00378715772811e-05,99811,25.0907491201609
"appareiller",19,0.000955253896430367,23,0.000192145429027326,119701,4,4.00757431545621e-05,99811,23.8362116641528
"atendre",33,0.00165912518853695,40,0.000334165963525785,119701,7,7.01325505204837e-05,99811,23.6569920275803
"conseillier",14,0.000703871292106586,17,0.000142020534498459,119701,3,3.00568073659216e-05,99811,23.4180325121502
"volenté",9,0.000452488687782805,11,9.18956399695909e-05,119701,2,2.00378715772811e-05,99811,22.5816742081448
"retorner",30,0.00150829562594268,37,0.000309103516261351,119701,7,7.01325505204837e-05,99811,21.5063563887093
"mentir",29,0.00145801910507793,36,0.000300749367173207,119701,7,7.01325505204837e-05,99811,20.789477842419
"novele",12,0.000603318250377074,15,0.000125312236322169,119701,3,3.00568073659216e-05,99811,20.0725992961287
"allumer",8,0.000402212166918049,10,8.35414908814463e-05,119701,2,2.00378715772811e-05,99811,20.0725992961287
"église",8,0.000402212166918049,10,8.35414908814463e-05,119701,2,2.00378715772811e-05,99811,20.0725992961287
"estable",8,0.000402212166918049,10,8.35414908814463e-05,119701,2,2.00378715772811e-05,99811,20.0725992961287
"guile",8,0.000402212166918049,10,8.35414908814463e-05,119701,2,2.00378715772811e-05,99811,20.0725992961287
"nommer",8,0.000402212166918049,10,8.35414908814463e-05,119701,2,2.00378715772811e-05,99811,20.0725992961287
"vent",8,0.000402212166918049,10,8.35414908814463e-05,119701,2,2.00378715772811e-05,99811,20.0725992961287
"isnellement",20,0.00100553041729512,25,0.000208853727203616,119701,5,5.00946789432027e-05,99811,20.0725992961287
"atorner",31,0.00155857214680744,39,0.00032581181443764,119701,8,8.01514863091242e-05,99811,19.4453305681247
"ennui",26,0.00130718954248366,33,0.000275686919908773,119701,7,7.01325505204837e-05,99811,18.6388422035481
"ataindre",11,0.000553041729512318,14,0.000116958087234025,119701,3,3.00568073659216e-05,99811,18.399882688118
"chapelain",11,0.000553041729512318,14,0.000116958087234025,119701,3,3.00568073659216e-05,99811,18.399882688118
"ciere",11,0.000553041729512318,14,0.000116958087234025,119701,3,3.00568073659216e-05,99811,18.399882688118
"entreprendre",11,0.000553041729512318,14,0.000116958087234025,119701,3,3.00568073659216e-05,99811,18.399882688118
"plaisir",11,0.000553041729512318,14,0.000116958087234025,119701,3,3.00568073659216e-05,99811,18.399882688118
"défendre",18,0.000904977375565611,23,0.000192145429027326,119701,5,5.00946789432027e-05,99811,18.0653393665158
"esbäir",18,0.000904977375565611,23,0.000192145429027326,119701,5,5.00946789432027e-05,99811,18.0653393665158
"argent",30,0.00150829562594268,39,0.00032581181443764,119701,9,9.01704220977648e-05,99811,16.7271660801073
"embler",20,0.00100553041729512,26,0.00021720787629176,119701,6,6.01136147318432e-05,99811,16.7271660801073
"eschaper",20,0.00100553041729512,26,0.00021720787629176,119701,6,6.01136147318432e-05,99811,16.7271660801073
"tendre",20,0.00100553041729512,26,0.00021720787629176,119701,6,6.01136147318432e-05,99811,16.7271660801073
"bonté",10,0.000502765208647562,13,0.00010860393814588,119701,3,3.00568073659216e-05,99811,16.7271660801073
"briément",10,0.000502765208647562,13,0.00010860393814588,119701,3,3.00568073659216e-05,99811,16.7271660801073
"crever",10,0.000502765208647562,13,0.00010860393814588,119701,3,3.00568073659216e-05,99811,16.7271660801073
"maintenir",10,0.000502765208647562,13,0.00010860393814588,119701,3,3.00568073659216e-05,99811,16.7271660801073
"nature",10,0.000502765208647562,13,0.00010860393814588,119701,3,3.00568073659216e-05,99811,16.7271660801073
"partie",10,0.000502765208647562,13,0.00010860393814588,119701,3,3.00568073659216e-05,99811,16.7271660801073
"reposer",10,0.000502765208647562,13,0.00010860393814588,119701,3,3.00568073659216e-05,99811,16.7271660801073
"esmaiier",13,0.00065359477124183,17,0.000142020534498459,119701,4,4.00757431545621e-05,99811,16.3089869281046
"tüer",16,0.000804424333836099,21,0.000175437130851037,119701,5,5.00946789432027e-05,99811,16.058079436903
"naistre",19,0.000955253896430367,25,0.000208853727203616,119701,6,6.01136147318432e-05,99811,15.8908077761019
"afaire",30,0.00150829562594268,40,0.000334165963525785,119701,10,0.000100189357886405,99811,15.0544494720965
"embrasser",12,0.000603318250377074,16,0.000133666385410314,119701,4,4.00757431545621e-05,99811,15.0544494720965
"travaillier",12,0.000603318250377074,16,0.000133666385410314,119701,4,4.00757431545621e-05,99811,15.0544494720965
"courtil",9,0.000452488687782805,12,0.000100249789057736,119701,3,3.00568073659216e-05,99811,15.0544494720965
"descovrir",9,0.000452488687782805,12,0.000100249789057736,119701,3,3.00568073659216e-05,99811,15.0544494720965
"servise",9,0.000452488687782805,12,0.000100249789057736,119701,3,3.00568073659216e-05,99811,15.0544494720965
"demorer",20,0.00100553041729512,27,0.000225562025379905,119701,7,7.01325505204837e-05,99811,14.3375709258062
"nu",34,0.00170940170940171,46,0.000384290858054653,119701,12,0.000120227229463686,99811,14.2180911680912
"requerre",14,0.000703871292106586,19,0.000158728832674748,119701,5,5.00946789432027e-05,99811,14.0508195072901
"trancher",14,0.000703871292106586,19,0.000158728832674748,119701,5,5.00946789432027e-05,99811,14.0508195072901
"ovrir",22,0.00110608345902464,30,0.000250624472644339,119701,8,8.01514863091242e-05,99811,13.7999120160885
"aprendre",32,0.0016088486676722,44,0.000367582559878364,119701,12,0.000120227229463686,99811,13.3817328640858
"dit",8,0.000402212166918049,11,9.18956399695909e-05,119701,3,3.00568073659216e-05,99811,13.3817328640858
"isnel",8,0.000402212166918049,11,9.18956399695909e-05,119701,3,3.00568073659216e-05,99811,13.3817328640858
"ivre",8,0.000402212166918049,11,9.18956399695909e-05,119701,3,3.00568073659216e-05,99811,13.3817328640858
"maisniee",8,0.000402212166918049,11,9.18956399695909e-05,119701,3,3.00568073659216e-05,99811,13.3817328640858
"paller",8,0.000402212166918049,11,9.18956399695909e-05,119701,3,3.00568073659216e-05,99811,13.3817328640858
"trembler",8,0.000402212166918049,11,9.18956399695909e-05,119701,3,3.00568073659216e-05,99811,13.3817328640858
"voie",61,0.00306686777275013,84,0.000701748523404149,119701,23,0.000230435523138732,99811,13.3090060550419
"delivrer",15,0.000754147812971342,21,0.000175437130851037,119701,6,6.01136147318432e-05,99811,12.5453745600804
"dépendre",15,0.000754147812971342,21,0.000175437130851037,119701,6,6.01136147318432e-05,99811,12.5453745600804
"plenté",15,0.000754147812971342,21,0.000175437130851037,119701,6,6.01136147318432e-05,99811,12.5453745600804
"afïer",10,0.000502765208647562,14,0.000116958087234025,119701,4,4.00757431545621e-05,99811,12.5453745600804
"embattre",10,0.000502765208647562,14,0.000116958087234025,119701,4,4.00757431545621e-05,99811,12.5453745600804
"semondre",10,0.000502765208647562,14,0.000116958087234025,119701,4,4.00757431545621e-05,99811,12.5453745600804
"ire",17,0.000854700854700855,24,0.000200499578115471,119701,7,7.01325505204837e-05,99811,12.1869352869353
"veillier",17,0.000854700854700855,24,0.000200499578115471,119701,7,7.01325505204837e-05,99811,12.1869352869353
"contraire",7,0.000351935646053293,10,8.35414908814463e-05,119701,3,3.00568073659216e-05,99811,11.7090162560751
"ennemi",7,0.000351935646053293,10,8.35414908814463e-05,119701,3,3.00568073659216e-05,99811,11.7090162560751
"esposer",7,0.000351935646053293,10,8.35414908814463e-05,119701,3,3.00568073659216e-05,99811,11.7090162560751
"nomer",7,0.000351935646053293,10,8.35414908814463e-05,119701,3,3.00568073659216e-05,99811,11.7090162560751
"oreille",7,0.000351935646053293,10,8.35414908814463e-05,119701,3,3.00568073659216e-05,99811,11.7090162560751
"poisson",7,0.000351935646053293,10,8.35414908814463e-05,119701,3,3.00568073659216e-05,99811,11.7090162560751
"seulement",7,0.000351935646053293,10,8.35414908814463e-05,119701,3,3.00568073659216e-05,99811,11.7090162560751
"attendre",20,0.00100553041729512,29,0.000242270323556194,119701,9,9.01704220977648e-05,99811,11.1514440534048
"compagnie",11,0.000553041729512318,16,0.000133666385410314,119701,5,5.00946789432027e-05,99811,11.0399296128708
"chier",37,0.00186023127199598,54,0.00045112405075981,119701,17,0.000170321908406889,99811,10.9218554993641
"aise",13,0.00065359477124183,19,0.000158728832674748,119701,6,6.01136147318432e-05,99811,10.8726579520697
"chemise",13,0.00065359477124183,19,0.000158728832674748,119701,6,6.01136147318432e-05,99811,10.8726579520697
"departir",13,0.00065359477124183,19,0.000158728832674748,119701,6,6.01136147318432e-05,99811,10.8726579520697
"ensemble",34,0.00170940170940171,50,0.000417707454407231,119701,16,0.000160302972618248,99811,10.6635683760684
"escouter",24,0.00120663650075415,36,0.000300749367173207,119701,12,0.000120227229463686,99811,10.0362996480644
"damage",8,0.000402212166918049,12,0.000100249789057736,119701,4,4.00757431545621e-05,99811,10.0362996480644
"lire",8,0.000402212166918049,12,0.000100249789057736,119701,4,4.00757431545621e-05,99811,10.0362996480644
"moillier",10,0.000502765208647562,15,0.000125312236322169,119701,5,5.00946789432027e-05,99811,10.0362996480644
"reprendre",10,0.000502765208647562,15,0.000125312236322169,119701,5,5.00946789432027e-05,99811,10.0362996480644
"sohaidier",10,0.000502765208647562,15,0.000125312236322169,119701,5,5.00946789432027e-05,99811,10.0362996480644
"vivre",17,0.000854700854700855,26,0.00021720787629176,119701,9,9.01704220977648e-05,99811,9.47872744539411
"fable",13,0.00065359477124183,20,0.000167082981762893,119701,7,7.01325505204837e-05,99811,9.31942110177404
"compagne",11,0.000553041729512318,17,0.000142020534498459,119701,6,6.01136147318432e-05,99811,9.19994134405899
"envie",11,0.000553041729512318,17,0.000142020534498459,119701,6,6.01136147318432e-05,99811,9.19994134405899
"grever",18,0.000904977375565611,28,0.00023391617446805,119701,10,0.000100189357886405,99811,9.03266968325792
"assembler",9,0.000452488687782805,14,0.000116958087234025,119701,5,5.00946789432027e-05,99811,9.03266968325792
"celer",9,0.000452488687782805,14,0.000116958087234025,119701,5,5.00946789432027e-05,99811,9.03266968325792
"ouvrir",16,0.000804424333836099,25,0.000208853727203616,119701,9,9.01704220977648e-05,99811,8.92115524272387
"rire",21,0.00105580693815988,33,0.000275686919908773,119701,12,0.000120227229463686,99811,8.78176219205631
"fête",14,0.000703871292106586,22,0.000183791279939182,119701,8,8.01514863091242e-05,99811,8.78176219205631
"manoir",14,0.000703871292106586,22,0.000183791279939182,119701,8,8.01514863091242e-05,99811,8.78176219205631
"couvrir",7,0.000351935646053293,11,9.18956399695909e-05,119701,4,4.00757431545621e-05,99811,8.78176219205631
"demi",7,0.000351935646053293,11,9.18956399695909e-05,119701,4,4.00757431545621e-05,99811,8.78176219205631
"dos",7,0.000351935646053293,11,9.18956399695909e-05,119701,4,4.00757431545621e-05,99811,8.78176219205631
"errer",7,0.000351935646053293,11,9.18956399695909e-05,119701,4,4.00757431545621e-05,99811,8.78176219205631
"esprover",7,0.000351935646053293,11,9.18956399695909e-05,119701,4,4.00757431545621e-05,99811,8.78176219205631
"laver",7,0.000351935646053293,11,9.18956399695909e-05,119701,4,4.00757431545621e-05,99811,8.78176219205631
"musart",7,0.000351935646053293,11,9.18956399695909e-05,119701,4,4.00757431545621e-05,99811,8.78176219205631
"pardoner",7,0.000351935646053293,11,9.18956399695909e-05,119701,4,4.00757431545621e-05,99811,8.78176219205631
"parfont",7,0.000351935646053293,11,9.18956399695909e-05,119701,4,4.00757431545621e-05,99811,8.78176219205631
"repondre",7,0.000351935646053293,11,9.18956399695909e-05,119701,4,4.00757431545621e-05,99811,8.78176219205631
"sain",7,0.000351935646053293,11,9.18956399695909e-05,119701,4,4.00757431545621e-05,99811,8.78176219205631
"ester",19,0.000955253896430367,30,0.000250624472644339,119701,11,0.000110208293675046,99811,8.66771333241921
"esveillier",19,0.000955253896430367,30,0.000250624472644339,119701,11,0.000110208293675046,99811,8.66771333241921
"entendre",74,0.00372046254399196,117,0.000977435443312921,119701,43,0.000430814238911543,99811,8.63588574368328
"étendre",12,0.000603318250377074,19,0.000158728832674748,119701,7,7.01325505204837e-05,99811,8.60254255548373
"vie",29,0.00145801910507793,46,0.000384290858054653,119701,17,0.000170321908406889,99811,8.56037322923136
"musser",15,0.000754147812971342,24,0.000200499578115471,119701,9,9.01704220977648e-05,99811,8.36358304005363
"covrir",10,0.000502765208647562,16,0.000133666385410314,119701,6,6.01136147318432e-05,99811,8.36358304005363
"encontrer",10,0.000502765208647562,16,0.000133666385410314,119701,6,6.01136147318432e-05,99811,8.36358304005363
"aidier",28,0.00140774258421317,45,0.000375936708966508,119701,17,0.000170321908406889,99811,8.26518794546476
"merveille",28,0.00140774258421317,45,0.000375936708966508,119701,17,0.000170321908406889,99811,8.26518794546476
"vendre",23,0.00115635997988939,37,0.000309103516261351,119701,14,0.000140265101040967,99811,8.24410328233858
"amender",8,0.000402212166918049,13,0.00010860393814588,119701,5,5.00946789432027e-05,99811,8.02903971845148
"drecier",8,0.000402212166918049,13,0.00010860393814588,119701,5,5.00946789432027e-05,99811,8.02903971845148
"escot",8,0.000402212166918049,13,0.00010860393814588,119701,5,5.00946789432027e-05,99811,8.02903971845148
"faillir",8,0.000402212166918049,13,0.00010860393814588,119701,5,5.00946789432027e-05,99811,8.02903971845148
"goutte",8,0.000402212166918049,13,0.00010860393814588,119701,5,5.00946789432027e-05,99811,8.02903971845148
"orendroit",8,0.000402212166918049,13,0.00010860393814588,119701,5,5.00946789432027e-05,99811,8.02903971845148
"pitié",8,0.000402212166918049,13,0.00010860393814588,119701,5,5.00946789432027e-05,99811,8.02903971845148
"prometre",8,0.000402212166918049,13,0.00010860393814588,119701,5,5.00946789432027e-05,99811,8.02903971845148
"pendre",38,0.00191050779286073,62,0.000517957243464967,119701,24,0.000240454458927373,99811,7.94540388805095
"regarder",22,0.00110608345902464,36,0.000300749367173207,119701,14,0.000140265101040967,99811,7.88566400919342
"finer",11,0.000553041729512318,18,0.000150374683586603,119701,7,7.01325505204837e-05,99811,7.88566400919342
"pasmer",11,0.000553041729512318,18,0.000150374683586603,119701,7,7.01325505204837e-05,99811,7.88566400919342
"commander",28,0.00140774258421317,46,0.000384290858054653,119701,18,0.00018034084419553,99811,7.80601083738339
"envoiier",14,0.000703871292106586,23,0.000192145429027326,119701,9,9.01704220977648e-05,99811,7.80601083738339
"plorer",14,0.000703871292106586,23,0.000192145429027326,119701,9,9.01704220977648e-05,99811,7.80601083738339
"pourpenser",14,0.000703871292106586,23,0.000192145429027326,119701,9,9.01704220977648e-05,99811,7.80601083738339
"salüer",17,0.000854700854700855,28,0.00023391617446805,119701,11,0.000110208293675046,99811,7.75532245532245
"bouter",23,0.00115635997988939,38,0.000317457665349496,119701,15,0.000150284036829608,99811,7.69449639684934
"mestier",30,0.00150829562594268,50,0.000417707454407231,119701,20,0.000200378715772811,99811,7.52722473604827
"demeurer",15,0.000754147812971342,25,0.000208853727203616,119701,10,0.000100189357886405,99811,7.52722473604827
"rue",15,0.000754147812971342,25,0.000208853727203616,119701,10,0.000100189357886405,99811,7.52722473604827
"fier",12,0.000603318250377074,20,0.000167082981762893,119701,8,8.01514863091242e-05,99811,7.52722473604827
"longuement",12,0.000603318250377074,20,0.000167082981762893,119701,8,8.01514863091242e-05,99811,7.52722473604827
"aerdre",9,0.000452488687782805,15,0.000125312236322169,119701,6,6.01136147318432e-05,99811,7.52722473604827
"novel",9,0.000452488687782805,15,0.000125312236322169,119701,6,6.01136147318432e-05,99811,7.52722473604827
"coute",6,0.000301659125188537,10,8.35414908814463e-05,119701,4,4.00757431545621e-05,99811,7.52722473604827
"desdire",6,0.000301659125188537,10,8.35414908814463e-05,119701,4,4.00757431545621e-05,99811,7.52722473604827
"Paul",6,0.000301659125188537,10,8.35414908814463e-05,119701,4,4.00757431545621e-05,99811,7.52722473604827
"porte",27,0.00135746606334842,45,0.000375936708966508,119701,18,0.00018034084419553,99811,7.52722473604826
"talent",21,0.00105580693815988,35,0.000292395218085062,119701,14,0.000140265101040967,99811,7.52722473604826
"merci",41,0.002061337355455,69,0.000576436287081979,119701,28,0.000280530202081935,99811,7.34800509947569
"movoir",16,0.000804424333836099,27,0.000225562025379905,119701,11,0.000110208293675046,99811,7.29912701677407
"oster",20,0.00100553041729512,34,0.000284041068996917,119701,14,0.000140265101040967,99811,7.16878546290311
"convent",10,0.000502765208647562,17,0.000142020534498459,119701,7,7.01325505204837e-05,99811,7.16878546290311
"don",10,0.000502765208647562,17,0.000142020534498459,119701,7,7.01325505204837e-05,99811,7.16878546290311
"fermer",10,0.000502765208647562,17,0.000142020534498459,119701,7,7.01325505204837e-05,99811,7.16878546290311
"chapon",7,0.000351935646053293,12,0.000100249789057736,119701,5,5.00946789432027e-05,99811,7.02540975364505
"esploitier",7,0.000351935646053293,12,0.000100249789057736,119701,5,5.00946789432027e-05,99811,7.02540975364505
"péché",7,0.000351935646053293,12,0.000100249789057736,119701,5,5.00946789432027e-05,99811,7.02540975364505
"repairer",7,0.000351935646053293,12,0.000100249789057736,119701,5,5.00946789432027e-05,99811,7.02540975364505
"sivre",7,0.000351935646053293,12,0.000100249789057736,119701,5,5.00946789432027e-05,99811,7.02540975364505
"fenestre",11,0.000553041729512318,19,0.000158728832674748,119701,8,8.01514863091242e-05,99811,6.89995600804424
"huchier",11,0.000553041729512318,19,0.000158728832674748,119701,8,8.01514863091242e-05,99811,6.89995600804424
"lasser",12,0.000603318250377074,21,0.000175437130851037,119701,9,9.01704220977648e-05,99811,6.6908664320429
"coi",8,0.000402212166918049,14,0.000116958087234025,119701,6,6.01136147318432e-05,99811,6.6908664320429
"endormir",8,0.000402212166918049,14,0.000116958087234025,119701,6,6.01136147318432e-05,99811,6.6908664320429
"merveiller",8,0.000402212166918049,14,0.000116958087234025,119701,6,6.01136147318432e-05,99811,6.6908664320429
"maison",98,0.0049270990447461,174,0.00145362194133717,119701,76,0.00076143911993668,99811,6.47077214151518
"lendemain",9,0.000452488687782805,16,0.000133666385410314,119701,7,7.01325505204837e-05,99811,6.4519069166128
"tart",9,0.000452488687782805,16,0.000133666385410314,119701,7,7.01325505204837e-05,99811,6.4519069166128
"garir",14,0.000703871292106586,25,0.000208853727203616,119701,11,0.000110208293675046,99811,6.38673613967732
"avis",19,0.000955253896430367,34,0.000284041068996917,119701,15,0.000150284036829608,99811,6.35632311044076
"esgarder",19,0.000955253896430367,34,0.000284041068996917,119701,15,0.000150284036829608,99811,6.35632311044076
"coper",10,0.000502765208647562,18,0.000150374683586603,119701,8,8.01514863091242e-05,99811,6.27268728004022
"maudire",10,0.000502765208647562,18,0.000150374683586603,119701,8,8.01514863091242e-05,99811,6.27268728004022
"apeler",45,0.00226244343891403,82,0.000685040225227859,119701,37,0.0003707006241797,99811,6.10315519139049
"avenir",23,0.00115635997988939,42,0.000350874261702074,119701,19,0.00019035977998417,99811,6.07460241856527
"enfer",6,0.000301659125188537,11,9.18956399695909e-05,119701,5,5.00946789432027e-05,99811,6.02177978883861
"gorge",6,0.000301659125188537,11,9.18956399695909e-05,119701,5,5.00946789432027e-05,99811,6.02177978883861
"pertris",6,0.000301659125188537,11,9.18956399695909e-05,119701,5,5.00946789432027e-05,99811,6.02177978883861
"privément",6,0.000301659125188537,11,9.18956399695909e-05,119701,5,5.00946789432027e-05,99811,6.02177978883861
"soper",6,0.000301659125188537,11,9.18956399695909e-05,119701,5,5.00946789432027e-05,99811,6.02177978883861
"voirement",6,0.000301659125188537,11,9.18956399695909e-05,119701,5,5.00946789432027e-05,99811,6.02177978883861
"vis",26,0.00130718954248366,48,0.000400999156230942,119701,22,0.000220416587350092,99811,5.93054070112894
"couchier",35,0.00175967823026647,65,0.000543019690729401,119701,30,0.000300568073659216,99811,5.85450812803754
"chaut",7,0.000351935646053293,13,0.00010860393814588,119701,6,6.01136147318432e-05,99811,5.85450812803754
"trespasser",7,0.000351935646053293,13,0.00010860393814588,119701,6,6.01136147318432e-05,99811,5.85450812803754
"voix",7,0.000351935646053293,13,0.00010860393814588,119701,6,6.01136147318432e-05,99811,5.85450812803754
"revenir",57,0.0028657616892911,106,0.000885539803343331,119701,49,0.000490927853643386,99811,5.8374395912211
"recevoir",23,0.00115635997988939,43,0.000359228410790219,119701,20,0.000200378715772811,99811,5.770872297637
"sage",31,0.00155857214680744,58,0.000484540647112388,119701,27,0.000270511266293294,99811,5.7615794275925
"aporter",40,0.00201106083459025,75,0.000626561181610847,119701,35,0.000350662752602419,99811,5.73502837032249
"cochier",8,0.000402212166918049,15,0.000125312236322169,119701,7,7.01325505204837e-05,99811,5.73502837032249
"gaber",8,0.000402212166918049,15,0.000125312236322169,119701,7,7.01325505204837e-05,99811,5.73502837032249
"octroyer",8,0.000402212166918049,15,0.000125312236322169,119701,7,7.01325505204837e-05,99811,5.73502837032249
"refaire",8,0.000402212166918049,15,0.000125312236322169,119701,7,7.01325505204837e-05,99811,5.73502837032249
"voisin",8,0.000402212166918049,15,0.000125312236322169,119701,7,7.01325505204837e-05,99811,5.73502837032249
"raison",34,0.00170940170940171,64,0.000534665541641256,119701,30,0.000300568073659216,99811,5.68723646723647
"gent",60,0.00301659125188537,113,0.000944018846960343,119701,53,0.000531003596797948,99811,5.68092432909303
"teste",26,0.00130718954248366,49,0.000409353305319087,119701,23,0.000230435523138732,99811,5.67269110542768
"loisir",9,0.000452488687782805,17,0.000142020534498459,119701,8,8.01514863091242e-05,99811,5.6454185520362
"Marie",9,0.000452488687782805,17,0.000142020534498459,119701,8,8.01514863091242e-05,99811,5.6454185520362
"ocire",9,0.000452488687782805,17,0.000142020534498459,119701,8,8.01514863091242e-05,99811,5.6454185520362
"os",9,0.000452488687782805,17,0.000142020534498459,119701,8,8.01514863091242e-05,99811,5.6454185520362
"monter",29,0.00145801910507793,55,0.000459478199847954,119701,26,0.000260492330504654,99811,5.59716711142051
"moi",10,0.000502765208647562,19,0.000158728832674748,119701,9,9.01704220977648e-05,99811,5.57572202670242
"salir",51,0.00256410256410256,97,0.000810352461550029,119701,46,0.000460871046277464,99811,5.56360089186176
"heure",21,0.00105580693815988,40,0.000334165963525785,119701,19,0.00019035977998417,99811,5.54637612129872
"haster",11,0.000553041729512318,21,0.000175437130851037,119701,10,0.000100189357886405,99811,5.51996480643539
"vif",11,0.000553041729512318,21,0.000175437130851037,119701,10,0.000100189357886405,99811,5.51996480643539
"table",12,0.000603318250377074,23,0.000192145429027326,119701,11,0.000110208293675046,99811,5.47434526258056
"raim",13,0.00065359477124183,25,0.000208853727203616,119701,12,0.000120227229463686,99811,5.43632897603486
"perdre",44,0.00221216691804927,85,0.000710102672492293,119701,41,0.000410776367334262,99811,5.38533151847356
"otroiier",15,0.000754147812971342,29,0.000242270323556194,119701,14,0.000140265101040967,99811,5.37658909717733
"sembler",35,0.00175967823026647,68,0.000568082137993835,119701,33,0.000330624881025138,99811,5.32228011639776
"jesir",30,0.00150829562594268,59,0.000492894796200533,119701,29,0.000290549137870575,99811,5.19118947313673
"assëoir",30,0.00150829562594268,60,0.000501248945288678,119701,30,0.000300568073659216,99811,5.01814982403218
"beste",15,0.000754147812971342,30,0.000250624472644339,119701,15,0.000150284036829608,99811,5.01814982403218
"comparer",15,0.000754147812971342,30,0.000250624472644339,119701,15,0.000150284036829608,99811,5.01814982403218
"aventure",33,0.00165912518853695,66,0.000551373839817545,119701,33,0.000330624881025138,99811,5.01814982403218
"verité",17,0.000854700854700855,34,0.000284041068996917,119701,17,0.000170321908406889,99811,5.01814982403218
"Martin",16,0.000804424333836099,32,0.000267332770820628,119701,16,0.000160302972618248,99811,5.01814982403218
"boter",14,0.000703871292106586,28,0.00023391617446805,119701,14,0.000140265101040967,99811,5.01814982403218
"chiere",13,0.00065359477124183,26,0.00021720787629176,119701,13,0.000130246165252327,99811,5.01814982403218
"baisier",11,0.000553041729512318,22,0.000183791279939182,119701,11,0.000110208293675046,99811,5.01814982403218
"provoire",11,0.000553041729512318,22,0.000183791279939182,119701,11,0.000110208293675046,99811,5.01814982403218
"saisir",11,0.000553041729512318,22,0.000183791279939182,119701,11,0.000110208293675046,99811,5.01814982403218
"uevre",11,0.000553041729512318,22,0.000183791279939182,119701,11,0.000110208293675046,99811,5.01814982403218
"besoigne",9,0.000452488687782805,18,0.000150374683586603,119701,9,9.01704220977648e-05,99811,5.01814982403218
"el",9,0.000452488687782805,18,0.000150374683586603,119701,9,9.01704220977648e-05,99811,5.01814982403218
"moulin",9,0.000452488687782805,18,0.000150374683586603,119701,9,9.01704220977648e-05,99811,5.01814982403218
"paiier",9,0.000452488687782805,18,0.000150374683586603,119701,9,9.01704220977648e-05,99811,5.01814982403218
"songier",9,0.000452488687782805,18,0.000150374683586603,119701,9,9.01704220977648e-05,99811,5.01814982403218
"command",8,0.000402212166918049,16,0.000133666385410314,119701,8,8.01514863091242e-05,99811,5.01814982403218
"derrier",8,0.000402212166918049,16,0.000133666385410314,119701,8,8.01514863091242e-05,99811,5.01814982403218
"douter",8,0.000402212166918049,16,0.000133666385410314,119701,8,8.01514863091242e-05,99811,5.01814982403218
"endroit",8,0.000402212166918049,16,0.000133666385410314,119701,8,8.01514863091242e-05,99811,5.01814982403218
"pais",8,0.000402212166918049,16,0.000133666385410314,119701,8,8.01514863091242e-05,99811,5.01814982403218
"degré",7,0.000351935646053293,14,0.000116958087234025,119701,7,7.01325505204837e-05,99811,5.01814982403218
"espee",7,0.000351935646053293,14,0.000116958087234025,119701,7,7.01325505204837e-05,99811,5.01814982403218
"pautonier",7,0.000351935646053293,14,0.000116958087234025,119701,7,7.01325505204837e-05,99811,5.01814982403218
"aimer",6,0.000301659125188537,12,0.000100249789057736,119701,6,6.01136147318432e-05,99811,5.01814982403218
"courroucer",6,0.000301659125188537,12,0.000100249789057736,119701,6,6.01136147318432e-05,99811,5.01814982403218
"envers",6,0.000301659125188537,12,0.000100249789057736,119701,6,6.01136147318432e-05,99811,5.01814982403218
"guise",6,0.000301659125188537,12,0.000100249789057736,119701,6,6.01136147318432e-05,99811,5.01814982403218
"hardi",6,0.000301659125188537,12,0.000100249789057736,119701,6,6.01136147318432e-05,99811,5.01814982403218
"tourner",6,0.000301659125188537,12,0.000100249789057736,119701,6,6.01136147318432e-05,99811,5.01814982403218
"plaire",20,0.00100553041729512,40,0.000334165963525785,119701,20,0.000200378715772811,99811,5.01814982403218
"cité",5,0.000251382604323781,10,8.35414908814463e-05,119701,5,5.00946789432027e-05,99811,5.01814982403218
"durer",5,0.000251382604323781,10,8.35414908814463e-05,119701,5,5.00946789432027e-05,99811,5.01814982403218
"enfermer",5,0.000251382604323781,10,8.35414908814463e-05,119701,5,5.00946789432027e-05,99811,5.01814982403218
"irier",5,0.000251382604323781,10,8.35414908814463e-05,119701,5,5.00946789432027e-05,99811,5.01814982403218
"livrer",5,0.000251382604323781,10,8.35414908814463e-05,119701,5,5.00946789432027e-05,99811,5.01814982403218
"naître",5,0.000251382604323781,10,8.35414908814463e-05,119701,5,5.00946789432027e-05,99811,5.01814982403218
"oblïer",5,0.000251382604323781,10,8.35414908814463e-05,119701,5,5.00946789432027e-05,99811,5.01814982403218
"promettre",5,0.000251382604323781,10,8.35414908814463e-05,119701,5,5.00946789432027e-05,99811,5.01814982403218
"quite",5,0.000251382604323781,10,8.35414908814463e-05,119701,5,5.00946789432027e-05,99811,5.01814982403218
"rompre",5,0.000251382604323781,10,8.35414908814463e-05,119701,5,5.00946789432027e-05,99811,5.01814982403218
"solier",5,0.000251382604323781,10,8.35414908814463e-05,119701,5,5.00946789432027e-05,99811,5.01814982403218
"rendre",33,0.00165912518853695,67,0.00055972798890569,119701,34,0.000340643816813778,99811,4.87055718214888
"baron",21,0.00105580693815988,43,0.000359228410790219,119701,22,0.000220416587350092,99811,4.79005210475799
"passer",21,0.00105580693815988,43,0.000359228410790219,119701,22,0.000220416587350092,99811,4.79005210475799
"torner",41,0.002061337355455,84,0.000701748523404149,119701,43,0.000430814238911543,99811,4.78474750663533
"conte",75,0.00377073906485671,154,0.00128653895957427,119701,79,0.000791495927302602,99811,4.76406628863814
"croire",30,0.00150829562594268,62,0.000517957243464967,119701,32,0.000320605945236497,99811,4.70451546003017
"arester",13,0.00065359477124183,27,0.000225562025379905,119701,14,0.000140265101040967,99811,4.65971055088702
"baillier",13,0.00065359477124183,27,0.000225562025379905,119701,14,0.000140265101040967,99811,4.65971055088702
"ardre",12,0.000603318250377074,25,0.000208853727203616,119701,13,0.000130246165252327,99811,4.63213829910663
"amener",10,0.000502765208647562,21,0.000175437130851037,119701,11,0.000110208293675046,99811,4.5619543854838
"main",54,0.00271493212669683,114,0.000952372996048487,119701,60,0.000601136147318432,99811,4.51633484162896
"corir",27,0.00135746606334842,57,0.000476186498024244,119701,30,0.000300568073659216,99811,4.51633484162896
"fin",17,0.000854700854700855,36,0.000300749367173207,119701,19,0.00019035977998417,99811,4.48992352676563
"parent",8,0.000402212166918049,17,0.000142020534498459,119701,9,9.01704220977648e-05,99811,4.46057762136194
"ravoir",8,0.000402212166918049,17,0.000142020534498459,119701,9,9.01704220977648e-05,99811,4.46057762136194
"retourner",7,0.000351935646053293,15,0.000125312236322169,119701,8,8.01514863091242e-05,99811,4.39088109602815
"mangier",24,0.00120663650075415,52,0.000434415752583521,119701,28,0.000280530202081935,99811,4.30127127774187
"convenir",12,0.000603318250377074,26,0.00021720787629176,119701,14,0.000140265101040967,99811,4.30127127774187
"arrière",6,0.000301659125188537,13,0.00010860393814588,119701,7,7.01325505204837e-05,99811,4.30127127774187
"Deniz",6,0.000301659125188537,13,0.00010860393814588,119701,7,7.01325505204837e-05,99811,4.30127127774187
"hautement",6,0.000301659125188537,13,0.00010860393814588,119701,7,7.01325505204837e-05,99811,4.30127127774187
"sougrestie",6,0.000301659125188537,13,0.00010860393814588,119701,7,7.01325505204837e-05,99811,4.30127127774187
"taster",6,0.000301659125188537,13,0.00010860393814588,119701,7,7.01325505204837e-05,99811,4.30127127774187
"demander",63,0.00316742081447964,137,0.00114451842507581,119701,74,0.000741401248359399,99811,4.27220863397334
"tens",11,0.000553041729512318,24,0.000200499578115471,119701,13,0.000130246165252327,99811,4.24612677418107
"peine",16,0.000804424333836099,35,0.000292395218085062,119701,19,0.00019035977998417,99811,4.22581037813236
"sëoir",21,0.00105580693815988,46,0.000384290858054653,119701,25,0.000250473394716013,99811,4.21524585218703
"moins",15,0.000754147812971342,33,0.000275686919908773,119701,18,0.00018034084419553,99811,4.18179152002681
"premier",15,0.000754147812971342,33,0.000275686919908773,119701,18,0.00018034084419553,99811,4.18179152002681
"trouver",20,0.00100553041729512,44,0.000367582559878364,119701,24,0.000240454458927373,99811,4.18179152002681
"chétif",5,0.000251382604323781,11,9.18956399695909e-05,119701,6,6.01136147318432e-05,99811,4.18179152002681
"cheveu",5,0.000251382604323781,11,9.18956399695909e-05,119701,6,6.01136147318432e-05,99811,4.18179152002681
"enfouir",5,0.000251382604323781,11,9.18956399695909e-05,119701,6,6.01136147318432e-05,99811,4.18179152002681
"graignor",5,0.000251382604323781,11,9.18956399695909e-05,119701,6,6.01136147318432e-05,99811,4.18179152002681
"nef",5,0.000251382604323781,11,9.18956399695909e-05,119701,6,6.01136147318432e-05,99811,4.18179152002681
"paistre",5,0.000251382604323781,11,9.18956399695909e-05,119701,6,6.01136147318432e-05,99811,4.18179152002681
"pis",5,0.000251382604323781,11,9.18956399695909e-05,119701,6,6.01136147318432e-05,99811,4.18179152002681
"pleurer",5,0.000251382604323781,11,9.18956399695909e-05,119701,6,6.01136147318432e-05,99811,4.18179152002681
"vit",5,0.000251382604323781,11,9.18956399695909e-05,119701,6,6.01136147318432e-05,99811,4.18179152002681
"volentiers",34,0.00170940170940171,75,0.000626561181610847,119701,41,0.000410776367334262,99811,4.16139253700229
"lever",47,0.00236299648064354,104,0.000868831505167041,119701,57,0.00057107933995251,99811,4.13777266192127
"choir",9,0.000452488687782805,20,0.000167082981762893,119701,11,0.000110208293675046,99811,4.10575894693542
"maistre",9,0.000452488687782805,20,0.000167082981762893,119701,11,0.000110208293675046,99811,4.10575894693542
"priier",16,0.000804424333836099,36,0.000300749367173207,119701,20,0.000200378715772811,99811,4.01451985922574
"bas",8,0.000402212166918049,18,0.000150374683586603,119701,10,0.000100189357886405,99811,4.01451985922574
"chaucier",8,0.000402212166918049,18,0.000150374683586603,119701,10,0.000100189357886405,99811,4.01451985922574
"deduit",8,0.000402212166918049,18,0.000150374683586603,119701,10,0.000100189357886405,99811,4.01451985922574
"gäaignier",11,0.000553041729512318,25,0.000208853727203616,119701,14,0.000140265101040967,99811,3.94283200459671
"morir",35,0.00175967823026647,80,0.00066833192705157,119701,45,0.000450852110488824,99811,3.90300541869169
"cure",14,0.000703871292106586,32,0.000267332770820628,119701,18,0.00018034084419553,99811,3.90300541869169
"chargier",7,0.000351935646053293,16,0.000133666385410314,119701,9,9.01704220977648e-05,99811,3.90300541869169
"maufé",7,0.000351935646053293,16,0.000133666385410314,119701,9,9.01704220977648e-05,99811,3.90300541869169
"orgueil",7,0.000351935646053293,16,0.000133666385410314,119701,9,9.01704220977648e-05,99811,3.90300541869169
"piece",7,0.000351935646053293,16,0.000133666385410314,119701,9,9.01704220977648e-05,99811,3.90300541869169
"parler",67,0.00336852689793866,154,0.00128653895957427,119701,87,0.000871647413611726,99811,3.86455216333513
"palefroi",10,0.000502765208647562,23,0.000192145429027326,119701,13,0.000130246165252327,99811,3.86011524925552
"querre",42,0.00211161387631976,97,0.000810352461550029,119701,55,0.000551041468375229,99811,3.83204168380639
"gré",16,0.000804424333836099,37,0.000309103516261351,119701,21,0.000210397651561451,99811,3.82335224688166
"mander",16,0.000804424333836099,37,0.000309103516261351,119701,21,0.000210397651561451,99811,3.82335224688166
"descendre",19,0.000955253896430367,44,0.000367582559878364,119701,25,0.000250473394716013,99811,3.81379386626445
"honte",68,0.00341880341880342,158,0.00131995555592685,119701,90,0.000901704220977648,99811,3.79149097815764
"penser",30,0.00150829562594268,70,0.000584790436170124,119701,40,0.000400757431545621,99811,3.76361236802413
"fuir",18,0.000904977375565611,42,0.000350874261702074,119701,24,0.000240454458927373,99811,3.76361236802413
"néant",12,0.000603318250377074,28,0.00023391617446805,119701,16,0.000160302972618248,99811,3.76361236802413
"montrer",9,0.000452488687782805,21,0.000175437130851037,119701,12,0.000120227229463686,99811,3.76361236802413
"chastel",6,0.000301659125188537,14,0.000116958087234025,119701,8,8.01514863091242e-05,99811,3.76361236802413
"cief",6,0.000301659125188537,14,0.000116958087234025,119701,8,8.01514863091242e-05,99811,3.76361236802413
"cuire",6,0.000301659125188537,14,0.000116958087234025,119701,8,8.01514863091242e-05,99811,3.76361236802413
"souffrir",6,0.000301659125188537,14,0.000116958087234025,119701,8,8.01514863091242e-05,99811,3.76361236802413
"traire",42,0.00211161387631976,98,0.000818706610638173,119701,56,0.00056106040416387,99811,3.76361236802413
"trover",58,0.00291603821015586,136,0.00113616427598767,119701,78,0.000781476991513961,99811,3.731444740947
"servir",25,0.0012569130216189,59,0.000492894796200533,119701,34,0.000340643816813778,99811,3.68981604708248
"donner",22,0.00110608345902464,52,0.000434415752583521,119701,30,0.000300568073659216,99811,3.6799765376236
"coiement",8,0.000402212166918049,19,0.000158728832674748,119701,11,0.000110208293675046,99811,3.64956350838704
"honneur",8,0.000402212166918049,19,0.000158728832674748,119701,11,0.000110208293675046,99811,3.64956350838704
"jomment",8,0.000402212166918049,19,0.000158728832674748,119701,11,0.000110208293675046,99811,3.64956350838704
"entrer",50,0.00251382604323781,119,0.000994143741489211,119701,69,0.000691306569416197,99811,3.63634045219723
"conter",52,0.00261437908496732,124,0.00103591448692993,119701,72,0.000721363376782118,99811,3.62421931735657
"garde",13,0.00065359477124183,31,0.000258978621732483,119701,18,0.00018034084419553,99811,3.62421931735657
"aider",5,0.000251382604323781,12,0.000100249789057736,119701,7,7.01325505204837e-05,99811,3.58439273145155
"ëur",5,0.000251382604323781,12,0.000100249789057736,119701,7,7.01325505204837e-05,99811,3.58439273145155
"fontaine",5,0.000251382604323781,12,0.000100249789057736,119701,7,7.01325505204837e-05,99811,3.58439273145155
"loing",5,0.000251382604323781,12,0.000100249789057736,119701,7,7.01325505204837e-05,99811,3.58439273145155
"retenir",5,0.000251382604323781,12,0.000100249789057736,119701,7,7.01325505204837e-05,99811,3.58439273145155
"porter",46,0.00231271995977878,111,0.000927310548784054,119701,65,0.000651230826261634,99811,3.55130602931508
"blanc",14,0.000703871292106586,34,0.000284041068996917,119701,20,0.000200378715772811,99811,3.51270487682252
"boçu",7,0.000351935646053293,17,0.000142020534498459,119701,10,0.000100189357886405,99811,3.51270487682252
"löer",7,0.000351935646053293,17,0.000142020534498459,119701,10,0.000100189357886405,99811,3.51270487682252
"paradis",7,0.000351935646053293,17,0.000142020534498459,119701,10,0.000100189357886405,99811,3.51270487682252
"ami",78,0.00392156862745098,190,0.00158728832674748,119701,112,0.00112212080832774,99811,3.49478291316527
"cort",25,0.0012569130216189,61,0.000509603094376822,119701,36,0.000360681688391059,99811,3.48482626668901
"devenir",9,0.000452488687782805,22,0.000183791279939182,119701,13,0.000130246165252327,99811,3.47410372432997
"quérir",9,0.000452488687782805,22,0.000183791279939182,119701,13,0.000130246165252327,99811,3.47410372432997
"folie",15,0.000754147812971342,37,0.000309103516261351,119701,22,0.000220416587350092,99811,3.42146578911285
"coup",19,0.000955253896430367,47,0.000392645007142797,119701,28,0.000280530202081935,99811,3.40517309487898
"fol",20,0.00100553041729512,50,0.000417707454407231,119701,30,0.000300568073659216,99811,3.34543321602145
"payer",12,0.000603318250377074,30,0.000250624472644339,119701,18,0.00018034084419553,99811,3.34543321602145
"congié",10,0.000502765208647562,25,0.000208853727203616,119701,15,0.000150284036829608,99811,3.34543321602145
"alumer",6,0.000301659125188537,15,0.000125312236322169,119701,9,9.01704220977648e-05,99811,3.34543321602145
"repentir",6,0.000301659125188537,15,0.000125312236322169,119701,9,9.01704220977648e-05,99811,3.34543321602145
"di",8,0.000402212166918049,20,0.000167082981762893,119701,12,0.000120227229463686,99811,3.34543321602145
"prier",8,0.000402212166918049,20,0.000167082981762893,119701,12,0.000120227229463686,99811,3.34543321602145
"écrier",4,0.000201106083459025,10,8.35414908814463e-05,119701,6,6.01136147318432e-05,99811,3.34543321602145
"gage",4,0.000201106083459025,10,8.35414908814463e-05,119701,6,6.01136147318432e-05,99811,3.34543321602145
"lai",4,0.000201106083459025,10,8.35414908814463e-05,119701,6,6.01136147318432e-05,99811,3.34543321602145
"soloir",4,0.000201106083459025,10,8.35414908814463e-05,119701,6,6.01136147318432e-05,99811,3.34543321602145
"père",21,0.00105580693815988,53,0.000442769901671665,119701,32,0.000320605945236497,99811,3.29316082202112
"chanter",15,0.000754147812971342,38,0.000317457665349496,119701,23,0.000230435523138732,99811,3.27270640697751
"lié",15,0.000754147812971342,38,0.000317457665349496,119701,23,0.000230435523138732,99811,3.27270640697751
"monde",15,0.000754147812971342,38,0.000317457665349496,119701,23,0.000230435523138732,99811,3.27270640697751
"advenir",31,0.00155857214680744,79,0.000659977777963426,119701,48,0.000480908917854745,99811,3.24088842802078
"bouche",9,0.000452488687782805,23,0.000192145429027326,119701,14,0.000140265101040967,99811,3.2259534583064
"oeil",9,0.000452488687782805,23,0.000192145429027326,119701,14,0.000140265101040967,99811,3.2259534583064
"amer",41,0.002061337355455,105,0.000877185654255186,119701,64,0.000641211890472994,99811,3.21475223102061
"issir",23,0.00115635997988939,59,0.000492894796200533,119701,36,0.000360681688391059,99811,3.20604016535389
"lieu",23,0.00115635997988939,59,0.000492894796200533,119701,36,0.000360681688391059,99811,3.20604016535389
"chaloir",7,0.000351935646053293,18,0.000150374683586603,119701,11,0.000110208293675046,99811,3.19336806983866
"pré",7,0.000351935646053293,18,0.000150374683586603,119701,11,0.000110208293675046,99811,3.19336806983866
"denier",33,0.00165912518853695,85,0.000710102672492293,119701,52,0.000520984661009308,99811,3.1845950806358
"tort",17,0.000854700854700855,44,0.000367582559878364,119701,27,0.000270511266293294,99811,3.15957581513137
"mener",39,0.00196078431372549,101,0.000843769057902607,119701,62,0.000621174018895713,99811,3.15657811511701
"joie",22,0.00110608345902464,57,0.000476186498024244,119701,35,0.000350662752602419,99811,3.15426560367737
"autel",5,0.000251382604323781,13,0.00010860393814588,119701,8,8.01514863091242e-05,99811,3.13634364002011
"blecier",5,0.000251382604323781,13,0.00010860393814588,119701,8,8.01514863091242e-05,99811,3.13634364002011
"chacier",5,0.000251382604323781,13,0.00010860393814588,119701,8,8.01514863091242e-05,99811,3.13634364002011
"couper",5,0.000251382604323781,13,0.00010860393814588,119701,8,8.01514863091242e-05,99811,3.13634364002011
"dur",5,0.000251382604323781,13,0.00010860393814588,119701,8,8.01514863091242e-05,99811,3.13634364002011
"frois",5,0.000251382604323781,13,0.00010860393814588,119701,8,8.01514863091242e-05,99811,3.13634364002011
"maltalent",5,0.000251382604323781,13,0.00010860393814588,119701,8,8.01514863091242e-05,99811,3.13634364002011
"membre",5,0.000251382604323781,13,0.00010860393814588,119701,8,8.01514863091242e-05,99811,3.13634364002011
"tirer",5,0.000251382604323781,13,0.00010860393814588,119701,8,8.01514863091242e-05,99811,3.13634364002011
"livre",23,0.00115635997988939,60,0.000501248945288678,119701,37,0.0003707006241797,99811,3.11939043115514
"vile",18,0.000904977375565611,47,0.000392645007142797,119701,29,0.000290549137870575,99811,3.11471368388204
"batre",31,0.00155857214680744,81,0.000676686076139715,119701,50,0.000500946789432027,99811,3.11125289089995
"pain",13,0.00065359477124183,34,0.000284041068996917,119701,21,0.000210397651561451,99811,3.10647370059135
"metre",105,0.0052790346907994,275,0.00229739099923977,119701,170,0.00170321908406889,99811,3.09944547954929
"prêt",8,0.000402212166918049,21,0.000175437130851037,119701,13,0.000130246165252327,99811,3.08809219940442
"peser",19,0.000955253896430367,50,0.000417707454407231,119701,31,0.000310587009447856,99811,3.0756402147294
"durement",11,0.000553041729512318,29,0.000242270323556194,119701,18,0.00018034084419553,99811,3.06664711468633
"cheval",14,0.000703871292106586,37,0.000309103516261351,119701,23,0.000230435523138732,99811,3.05452597984567
"fort",15,0.000754147812971342,40,0.000334165963525785,119701,25,0.000250473394716013,99811,3.01088989441931
"taire",15,0.000754147812971342,40,0.000334165963525785,119701,25,0.000250473394716013,99811,3.01088989441931
"sale",6,0.000301659125188537,16,0.000133666385410314,119701,10,0.000100189357886405,99811,3.01088989441931
"partir",19,0.000955253896430367,51,0.000426061603495376,119701,32,0.000320605945236497,99811,2.9795264580191
"terre",32,0.0016088486676722,86,0.000718456821580438,119701,54,0.000541022532586589,99811,2.97371841424129
"parole",20,0.00100553041729512,54,0.00045112405075981,119701,34,0.000340643816813778,99811,2.95185283766599
"päis",10,0.000502765208647562,27,0.000225562025379905,119701,17,0.000170321908406889,99811,2.95185283766599
"escrïer",7,0.000351935646053293,19,0.000158728832674748,119701,12,0.000120227229463686,99811,2.92725406401877
"répondre",11,0.000553041729512318,30,0.000250624472644339,119701,19,0.00019035977998417,99811,2.905244634966
"remanoir",26,0.00130718954248366,71,0.000593144585258268,119701,45,0.000450852110488824,99811,2.89937545388526
"boivre",19,0.000955253896430367,52,0.000434415752583521,119701,33,0.000330624881025138,99811,2.88923777747307
"covoitier",4,0.000201106083459025,11,9.18956399695909e-05,119701,7,7.01325505204837e-05,99811,2.86751418516124
"itant",4,0.000201106083459025,11,9.18956399695909e-05,119701,7,7.01325505204837e-05,99811,2.86751418516124
"Robert",4,0.000201106083459025,11,9.18956399695909e-05,119701,7,7.01325505204837e-05,99811,2.86751418516124
"songe",4,0.000201106083459025,11,9.18956399695909e-05,119701,7,7.01325505204837e-05,99811,2.86751418516124
"part",35,0.00175967823026647,97,0.000810352461550029,119701,62,0.000621174018895713,99811,2.83282651356655
"manger",36,0.00180995475113122,100,0.000835414908814463,119701,64,0.000641211890472994,99811,2.8227092760181
"messe",9,0.000452488687782805,25,0.000208853727203616,119701,16,0.000160302972618248,99811,2.8227092760181
"jeter",23,0.00115635997988939,64,0.000534665541641256,119701,41,0.000410776367334262,99811,2.8150596573839
"foutre",10,0.000502765208647562,28,0.00023391617446805,119701,18,0.00018034084419553,99811,2.78786101335121
"baston",5,0.000251382604323781,14,0.000116958087234025,119701,9,9.01704220977648e-05,99811,2.78786101335121
"hurter",5,0.000251382604323781,14,0.000116958087234025,119701,9,9.01704220977648e-05,99811,2.78786101335121
"mire",5,0.000251382604323781,14,0.000116958087234025,119701,9,9.01704220977648e-05,99811,2.78786101335121
"us",5,0.000251382604323781,14,0.000116958087234025,119701,9,9.01704220977648e-05,99811,2.78786101335121
"vëoir",145,0.00729009552538964,410,0.0034252011261393,119701,265,0.00265501798398974,99811,2.74578009239496
"tenir",93,0.00467571644042232,263,0.00219714121018204,119701,170,0.00170321908406889,99811,2.74522313902937
"ariere",12,0.000603318250377074,34,0.000284041068996917,119701,22,0.000220416587350092,99811,2.73717263129028
"falir",19,0.000955253896430367,54,0.00045112405075981,119701,35,0.000350662752602419,99811,2.72413847590318
"matin",13,0.00065359477124183,37,0.000309103516261351,119701,24,0.000240454458927373,99811,2.71816448801743
"corps",33,0.00165912518853695,94,0.000785290014285595,119701,61,0.000611155083107072,99811,2.71473679005019
"garder",38,0.00191050779286073,109,0.000910602250607764,119701,71,0.000711344440993478,99811,2.68577032835525
"acheter",8,0.000402212166918049,23,0.000192145429027326,119701,15,0.000150284036829608,99811,2.67634657281716
"voir",62,0.00311714429361488,179,0.00149539268677789,119701,117,0.00117221548727094,99811,2.65919050504269
"jus",9,0.000452488687782805,26,0.00021720787629176,119701,17,0.000170321908406889,99811,2.65666755389939
"prendre",138,0.00693815987933635,400,0.00334165963525785,119701,262,0.00262496117662382,99811,2.64314761723832
"seror",13,0.00065359477124183,38,0.000317457665349496,119701,25,0.000250473394716013,99811,2.60943790849673
"sens",16,0.000804424333836099,47,0.000392645007142797,119701,31,0.000310587009447856,99811,2.5900128124037
"ame",17,0.000854700854700855,50,0.000417707454407231,119701,33,0.000330624881025138,99811,2.58510748510749
"feu",26,0.00130718954248366,77,0.000643269479787136,119701,51,0.000510965725220667,99811,2.55827245931052
"valoir",23,0.00115635997988939,69,0.000576436287081979,119701,46,0.000460871046277464,99811,2.50907491201609
"gros",12,0.000603318250377074,36,0.000300749367173207,119701,24,0.000240454458927373,99811,2.50907491201609
"demain",8,0.000402212166918049,24,0.000200499578115471,119701,16,0.000160302972618248,99811,2.50907491201609
"gens",7,0.000351935646053293,21,0.000175437130851037,119701,14,0.000140265101040967,99811,2.50907491201609
"jeu",7,0.000351935646053293,21,0.000175437130851037,119701,14,0.000140265101040967,99811,2.50907491201609
"acoler",6,0.000301659125188537,18,0.000150374683586603,119701,12,0.000120227229463686,99811,2.50907491201609
"ues",6,0.000301659125188537,18,0.000150374683586603,119701,12,0.000120227229463686,99811,2.50907491201609
"dépouiller",4,0.000201106083459025,12,0.000100249789057736,119701,8,8.01514863091242e-05,99811,2.50907491201609
"herbergier",4,0.000201106083459025,12,0.000100249789057736,119701,8,8.01514863091242e-05,99811,2.50907491201609
"malement",4,0.000201106083459025,12,0.000100249789057736,119701,8,8.01514863091242e-05,99811,2.50907491201609
"sohait",4,0.000201106083459025,12,0.000100249789057736,119701,8,8.01514863091242e-05,99811,2.50907491201609
"sot",4,0.000201106083459025,12,0.000100249789057736,119701,8,8.01514863091242e-05,99811,2.50907491201609
"lait",10,0.000502765208647562,30,0.000250624472644339,119701,20,0.000200378715772811,99811,2.50907491201609
"an",5,0.000251382604323781,15,0.000125312236322169,119701,10,0.000100189357886405,99811,2.50907491201609
"boire",5,0.000251382604323781,15,0.000125312236322169,119701,10,0.000100189357886405,99811,2.50907491201609
"raconter",5,0.000251382604323781,15,0.000125312236322169,119701,10,0.000100189357886405,99811,2.50907491201609
"sentir",20,0.00100553041729512,61,0.000509603094376822,119701,41,0.000410776367334262,99811,2.44787796294252
"droit",54,0.00271493212669683,166,0.00138678874863201,119701,112,0.00112212080832774,99811,2.4194650937298
"avant",25,0.0012569130216189,77,0.000643269479787136,119701,52,0.000520984661009308,99811,2.4125720307847
"point",21,0.00105580693815988,65,0.000543019690729401,119701,44,0.000440833174700183,99811,2.39502605237899
"dolent",10,0.000502765208647562,31,0.000258978621732483,119701,21,0.000210397651561451,99811,2.38959515430104
"marché",9,0.000452488687782805,28,0.00023391617446805,119701,19,0.00019035977998417,99811,2.37701833769945
"crïer",14,0.000703871292106586,44,0.000367582559878364,119701,30,0.000300568073659216,99811,2.34180325121502
"Travers",7,0.000351935646053293,22,0.000183791279939182,119701,15,0.000150284036829608,99811,2.34180325121502
"gésir",12,0.000603318250377074,38,0.000317457665349496,119701,26,0.000260492330504654,99811,2.31606914955331
"jadis",6,0.000301659125188537,19,0.000158728832674748,119701,13,0.000130246165252327,99811,2.31606914955331
"mourir",20,0.00100553041729512,64,0.000534665541641256,119701,44,0.000440833174700183,99811,2.2809771927419
"larron",10,0.000502765208647562,32,0.000267332770820628,119701,22,0.000220416587350092,99811,2.2809771927419
"grue",5,0.000251382604323781,16,0.000133666385410314,119701,11,0.000110208293675046,99811,2.2809771927419
"anel",9,0.000452488687782805,29,0.000242270323556194,119701,20,0.000200378715772811,99811,2.25816742081448
"doner",53,0.00266465560583208,171,0.00142855949407273,119701,118,0.00118223442305958,99811,2.25391475147208
"damoiselle",12,0.000603318250377074,39,0.00032581181443764,119701,27,0.000270511266293294,99811,2.23028881068097
"chandoile",4,0.000201106083459025,13,0.00010860393814588,119701,9,9.01704220977648e-05,99811,2.23028881068097
"chien",4,0.000201106083459025,13,0.00010860393814588,119701,9,9.01704220977648e-05,99811,2.23028881068097
"mois",4,0.000201106083459025,13,0.00010860393814588,119701,9,9.01704220977648e-05,99811,2.23028881068097
"mouton",4,0.000201106083459025,13,0.00010860393814588,119701,9,9.01704220977648e-05,99811,2.23028881068097
"sercot",4,0.000201106083459025,13,0.00010860393814588,119701,9,9.01704220977648e-05,99811,2.23028881068097
"mie",66,0.00331825037707391,215,0.00179614205395109,119701,149,0.00149282143250744,99811,2.2228046200411
"covenir",12,0.000603318250377074,40,0.000334165963525785,119701,28,0.000280530202081935,99811,2.15063563887093
"noir",6,0.000301659125188537,20,0.000167082981762893,119701,14,0.000140265101040967,99811,2.15063563887093
"Davier",3,0.000150829562594268,10,8.35414908814463e-05,119701,7,7.01325505204837e-05,99811,2.15063563887093
"Haimet",3,0.000150829562594268,10,8.35414908814463e-05,119701,7,7.01325505204837e-05,99811,2.15063563887093
"matiere",3,0.000150829562594268,10,8.35414908814463e-05,119701,7,7.01325505204837e-05,99811,2.15063563887093
"mes",3,0.000150829562594268,10,8.35414908814463e-05,119701,7,7.01325505204837e-05,99811,2.15063563887093
"ord",3,0.000150829562594268,10,8.35414908814463e-05,119701,7,7.01325505204837e-05,99811,2.15063563887093
"povreté",3,0.000150829562594268,10,8.35414908814463e-05,119701,7,7.01325505204837e-05,99811,2.15063563887093
"bois",11,0.000553041729512318,37,0.000309103516261351,119701,26,0.000260492330504654,99811,2.12306338709054
"moutier",10,0.000502765208647562,34,0.000284041068996917,119701,24,0.000240454458927373,99811,2.09089576001341
"Auberre",5,0.000251382604323781,17,0.000142020534498459,119701,12,0.000120227229463686,99811,2.09089576001341
"desus",5,0.000251382604323781,17,0.000142020534498459,119701,12,0.000120227229463686,99811,2.09089576001341
"petit",19,0.000955253896430367,65,0.000543019690729401,119701,46,0.000460871046277464,99811,2.07271405775242
"faus",7,0.000351935646053293,24,0.000200499578115471,119701,17,0.000170321908406889,99811,2.06629698636619
"lit",31,0.00155857214680744,107,0.000893893952431475,119701,76,0.00076143911993668,99811,2.04687690190786
"chëoir",11,0.000553041729512318,38,0.000317457665349496,119701,27,0.000270511266293294,99811,2.04443140979089
"chief",26,0.00130718954248366,90,0.000751873417933016,119701,64,0.000641211890472994,99811,2.03862336601307
"escuier",8,0.000402212166918049,28,0.00023391617446805,119701,20,0.000200378715772811,99811,2.00725992961287
"fois",8,0.000402212166918049,28,0.00023391617446805,119701,20,0.000200378715772811,99811,2.00725992961287
"häir",4,0.000201106083459025,14,0.000116958087234025,119701,10,0.000100189357886405,99811,2.00725992961287
"niece",4,0.000201106083459025,14,0.000116958087234025,119701,10,0.000100189357886405,99811,2.00725992961287
"rover",4,0.000201106083459025,14,0.000116958087234025,119701,10,0.000100189357886405,99811,2.00725992961287
"sofrir",4,0.000201106083459025,14,0.000116958087234025,119701,10,0.000100189357886405,99811,2.00725992961287
"teindre",4,0.000201106083459025,14,0.000116958087234025,119701,10,0.000100189357886405,99811,2.00725992961287
"venir",171,0.0085972850678733,606,0.00506261434741564,119701,435,0.00435823706805863,99811,1.97265199979196
"poing",11,0.000553041729512318,39,0.00032581181443764,119701,28,0.000280530202081935,99811,1.97141600229836
"clamer",7,0.000351935646053293,25,0.000208853727203616,119701,18,0.00018034084419553,99811,1.95150270934585
"seul",7,0.000351935646053293,25,0.000208853727203616,119701,18,0.00018034084419553,99811,1.95150270934585
"mot",22,0.00110608345902464,79,0.000659977777963426,119701,57,0.00057107933995251,99811,1.936829756644
"bailler",5,0.000251382604323781,18,0.000150374683586603,119701,13,0.000130246165252327,99811,1.93005762462776
"huche",5,0.000251382604323781,18,0.000150374683586603,119701,13,0.000130246165252327,99811,1.93005762462776
"cortois",8,0.000402212166918049,29,0.000242270323556194,119701,21,0.000210397651561451,99811,1.91167612344083
"laissier",11,0.000553041729512318,40,0.000334165963525785,119701,29,0.000290549137870575,99811,1.90343614015014
"mere",14,0.000703871292106586,51,0.000426061603495376,119701,37,0.0003707006241797,99811,1.89875939287704
"amour",6,0.000301659125188537,22,0.000183791279939182,119701,16,0.000160302972618248,99811,1.88180618401207
"connaître",6,0.000301659125188537,22,0.000183791279939182,119701,16,0.000160302972618248,99811,1.88180618401207
"ici",6,0.000301659125188537,22,0.000183791279939182,119701,16,0.000160302972618248,99811,1.88180618401207
"franc",3,0.000150829562594268,11,9.18956399695909e-05,119701,8,8.01514863091242e-05,99811,1.88180618401207
"Gombert",3,0.000150829562594268,11,9.18956399695909e-05,119701,8,8.01514863091242e-05,99811,1.88180618401207
"jugement",3,0.000150829562594268,11,9.18956399695909e-05,119701,8,8.01514863091242e-05,99811,1.88180618401207
"dis",7,0.000351935646053293,26,0.00021720787629176,119701,19,0.00019035977998417,99811,1.84879204043291
"force",7,0.000351935646053293,26,0.00021720787629176,119701,19,0.00019035977998417,99811,1.84879204043291
"maintenant",25,0.0012569130216189,93,0.00077693586519745,119701,68,0.000681287633627556,99811,1.84490802354124
"col",11,0.000553041729512318,41,0.00034252011261393,119701,30,0.000300568073659216,99811,1.8399882688118
"non",15,0.000754147812971342,56,0.000467832348936099,119701,41,0.000410776367334262,99811,1.83590847220689
"coille",8,0.000402212166918049,30,0.000250624472644339,119701,22,0.000220416587350092,99811,1.82478175419352
"amont",4,0.000201106083459025,15,0.000125312236322169,119701,11,0.000110208293675046,99811,1.82478175419352
"blé",4,0.000201106083459025,15,0.000125312236322169,119701,11,0.000110208293675046,99811,1.82478175419352
"defors",4,0.000201106083459025,15,0.000125312236322169,119701,11,0.000110208293675046,99811,1.82478175419352
"noise",4,0.000201106083459025,15,0.000125312236322169,119701,11,0.000110208293675046,99811,1.82478175419352
"tolir",4,0.000201106083459025,15,0.000125312236322169,119701,11,0.000110208293675046,99811,1.82478175419352
"chose",22,0.00110608345902464,83,0.000693394374316004,119701,61,0.000611155083107072,99811,1.80982452670013
"fosse",5,0.000251382604323781,19,0.000158728832674748,119701,14,0.000140265101040967,99811,1.79219636572578
"savoir",164,0.00824534942182001,627,0.00523805147826668,119701,463,0.00463876727014057,99811,1.77748719468958
"cras",6,0.000301659125188537,23,0.000192145429027326,119701,17,0.000170321908406889,99811,1.77111170259959
"pro",31,0.00155857214680744,119,0.000994143741489211,119701,88,0.000881666349400367,99811,1.76775732437497
"laiier",8,0.000402212166918049,31,0.000258978621732483,119701,23,0.000230435523138732,99811,1.74544341705467
"mort",10,0.000502765208647562,39,0.00032581181443764,119701,29,0.000290549137870575,99811,1.73039649104558
"dormir",13,0.00065359477124183,51,0.000426061603495376,119701,38,0.00038071955996834,99811,1.71673546611627
"respondre",22,0.00110608345902464,87,0.000726810970668583,119701,65,0.000651230826261634,99811,1.69845070967243
"rien",40,0.00201106083459025,159,0.001328309705015,119701,119,0.00119225335884822,99811,1.68677305009485
"oser",12,0.000603318250377074,48,0.000400999156230942,119701,36,0.000360681688391059,99811,1.67271660801073
"œil",10,0.000502765208647562,40,0.000334165963525785,119701,30,0.000300568073659216,99811,1.67271660801073
"sou",5,0.000251382604323781,20,0.000167082981762893,119701,15,0.000150284036829608,99811,1.67271660801073
"viz",5,0.000251382604323781,20,0.000167082981762893,119701,15,0.000150284036829608,99811,1.67271660801073
"doi",3,0.000150829562594268,12,0.000100249789057736,119701,9,9.01704220977648e-05,99811,1.67271660801073
"doter",3,0.000150829562594268,12,0.000100249789057736,119701,9,9.01704220977648e-05,99811,1.67271660801073
"fi",3,0.000150829562594268,12,0.000100249789057736,119701,9,9.01704220977648e-05,99811,1.67271660801073
"serjant",3,0.000150829562594268,12,0.000100249789057736,119701,9,9.01704220977648e-05,99811,1.67271660801073
"ville",3,0.000150829562594268,12,0.000100249789057736,119701,9,9.01704220977648e-05,99811,1.67271660801073
"duel",8,0.000402212166918049,32,0.000267332770820628,119701,24,0.000240454458927373,99811,1.67271660801073
"cote",4,0.000201106083459025,16,0.000133666385410314,119701,12,0.000120227229463686,99811,1.67271660801073
"ostel",28,0.00140774258421317,115,0.000960727145136632,119701,87,0.000871647413611726,99811,1.61503672497587
"aval",8,0.000402212166918049,33,0.000275686919908773,119701,25,0.000250473394716013,99811,1.6058079436903
"jurer",8,0.000402212166918049,33,0.000275686919908773,119701,25,0.000250473394716013,99811,1.6058079436903
"souvent",14,0.000703871292106586,58,0.000484540647112388,119701,44,0.000440833174700183,99811,1.59668403491933
"fablel",7,0.000351935646053293,29,0.000242270323556194,119701,22,0.000220416587350092,99811,1.59668403491933
"sien",12,0.000603318250377074,50,0.000417707454407231,119701,38,0.00038071955996834,99811,1.58467889179963
"aler",133,0.00668677727501257,565,0.00472009423480171,119701,432,0.00432818026069271,99811,1.5449396448988
"foiz",12,0.000603318250377074,51,0.000426061603495376,119701,39,0.000390738495756981,99811,1.54404609970221
"coutel",4,0.000201106083459025,17,0.000142020534498459,119701,13,0.000130246165252327,99811,1.54404609970221
"faim",4,0.000201106083459025,17,0.000142020534498459,119701,13,0.000130246165252327,99811,1.54404609970221
"semblant",4,0.000201106083459025,17,0.000142020534498459,119701,13,0.000130246165252327,99811,1.54404609970221
"mi",11,0.000553041729512318,47,0.000392645007142797,119701,36,0.000360681688391059,99811,1.53332355734317
"drap",7,0.000351935646053293,30,0.000250624472644339,119701,23,0.000230435523138732,99811,1.52726298992284
"honir",7,0.000351935646053293,30,0.000250624472644339,119701,23,0.000230435523138732,99811,1.52726298992284
"catre",6,0.000301659125188537,26,0.00021720787629176,119701,20,0.000200378715772811,99811,1.50544494720965
"estormettre",6,0.000301659125188537,26,0.00021720787629176,119701,20,0.000200378715772811,99811,1.50544494720965
"estovoir",6,0.000301659125188537,26,0.00021720787629176,119701,20,0.000200378715772811,99811,1.50544494720965
"clef",3,0.000150829562594268,13,0.00010860393814588,119701,10,0.000100189357886405,99811,1.50544494720965
"terme",3,0.000150829562594268,13,0.00010860393814588,119701,10,0.000100189357886405,99811,1.50544494720965
"tor",3,0.000150829562594268,13,0.00010860393814588,119701,10,0.000100189357886405,99811,1.50544494720965
"laisser",20,0.00100553041729512,88,0.000735165119756727,119701,68,0.000681287633627556,99811,1.47592641883299
"conseil",8,0.000402212166918049,36,0.000300749367173207,119701,28,0.000280530202081935,99811,1.43375709258062
"hors",8,0.000402212166918049,36,0.000300749367173207,119701,28,0.000280530202081935,99811,1.43375709258062
"borse",4,0.000201106083459025,18,0.000150374683586603,119701,14,0.000140265101040967,99811,1.43375709258062
"comtesse",4,0.000201106083459025,18,0.000150374683586603,119701,14,0.000140265101040967,99811,1.43375709258062
"dedans",13,0.00065359477124183,59,0.000492894796200533,119701,46,0.000460871046277464,99811,1.41817277635692
"öir",33,0.00165912518853695,151,0.00126147651230984,119701,118,0.00118223442305958,99811,1.40338088299205
"haut",17,0.000854700854700855,78,0.000651623628875281,119701,61,0.000611155083107072,99811,1.39850077063192
"plein",19,0.000955253896430367,88,0.000735165119756727,119701,69,0.000691306569416197,99811,1.38180937183495
"courir",6,0.000301659125188537,28,0.00023391617446805,119701,22,0.000220416587350092,99811,1.36858631564514
"ier",3,0.000150829562594268,14,0.000116958087234025,119701,11,0.000110208293675046,99811,1.36858631564514
"meschine",3,0.000150829562594268,14,0.000116958087234025,119701,11,0.000110208293675046,99811,1.36858631564514
"putain",3,0.000150829562594268,14,0.000116958087234025,119701,11,0.000110208293675046,99811,1.36858631564514
"foi",20,0.00100553041729512,94,0.000785290014285595,119701,74,0.000741401248359399,99811,1.35625670919789
"mari",11,0.000553041729512318,52,0.000434415752583521,119701,41,0.000410776367334262,99811,1.34633287961839
"braie",4,0.000201106083459025,19,0.000158728832674748,119701,15,0.000150284036829608,99811,1.33817328640858
"Mabile",4,0.000201106083459025,19,0.000158728832674748,119701,15,0.000150284036829608,99811,1.33817328640858
"chevalier",37,0.00186023127199598,176,0.00147033023951345,119701,139,0.00139263207462103,99811,1.33576649992223
"mauvais",9,0.000452488687782805,43,0.000359228410790219,119701,34,0.000340643816813778,99811,1.32833377694969
"pié",11,0.000553041729512318,53,0.000442769901671665,119701,42,0.000420795303122902,99811,1.31427733486557
"bel",59,0.00296631473102061,285,0.00238093249012122,119701,226,0.00226427948823276,99811,1.31004796291106
"enfant",6,0.000301659125188537,29,0.000242270323556194,119701,23,0.000230435523138732,99811,1.309082562791
"diable",7,0.000351935646053293,34,0.000284041068996917,119701,27,0.000270511266293294,99811,1.30100180623056
"vestir",7,0.000351935646053293,34,0.000284041068996917,119701,27,0.000270511266293294,99811,1.30100180623056
"ci",34,0.00170940170940171,167,0.00139514289772015,119701,133,0.00133251845988919,99811,1.28283529336161
"assez",30,0.00150829562594268,150,0.00125312236322169,119701,120,0.00120227229463686,99811,1.25453745600804
"temps",6,0.000301659125188537,30,0.000250624472644339,119701,24,0.000240454458927373,99811,1.25453745600804
"travers",4,0.000201106083459025,20,0.000167082981762893,119701,16,0.000160302972618248,99811,1.25453745600804
"autrement",3,0.000150829562594268,15,0.000125312236322169,119701,12,0.000120227229463686,99811,1.25453745600804
"bain",3,0.000150829562594268,15,0.000125312236322169,119701,12,0.000120227229463686,99811,1.25453745600804
"blasmer",2,0.000100553041729512,10,8.35414908814463e-05,119701,8,8.01514863091242e-05,99811,1.25453745600804
"boçus",2,0.000100553041729512,10,8.35414908814463e-05,119701,8,8.01514863091242e-05,99811,1.25453745600804
"bouchier",2,0.000100553041729512,10,8.35414908814463e-05,119701,8,8.01514863091242e-05,99811,1.25453745600804
"cuider",2,0.000100553041729512,10,8.35414908814463e-05,119701,8,8.01514863091242e-05,99811,1.25453745600804
"forment",2,0.000100553041729512,10,8.35414908814463e-05,119701,8,8.01514863091242e-05,99811,1.25453745600804
"Isenne",2,0.000100553041729512,10,8.35414908814463e-05,119701,8,8.01514863091242e-05,99811,1.25453745600804
"monnier",5,0.000251382604323781,25,0.000208853727203616,119701,20,0.000200378715772811,99811,1.25453745600804
"sauf",5,0.000251382604323781,25,0.000208853727203616,119701,20,0.000200378715772811,99811,1.25453745600804
"aller",31,0.00155857214680744,157,0.00131160140683871,119701,126,0.00126238590936871,99811,1.23462416305554
"bacon",12,0.000603318250377074,61,0.000509603094376822,119701,49,0.000490927853643386,99811,1.22893465078339
"dalez",6,0.000301659125188537,31,0.000258978621732483,119701,25,0.000250473394716013,99811,1.20435595776772
"criembre",5,0.000251382604323781,26,0.00021720787629176,119701,21,0.000210397651561451,99811,1.19479757715052
"pel",9,0.000452488687782805,47,0.000392645007142797,119701,38,0.00038071955996834,99811,1.18850916884973
"vin",13,0.00065359477124183,68,0.000568082137993835,119701,55,0.000551041468375229,99811,1.18610814022579
"ome",12,0.000603318250377074,63,0.000526311392553112,119701,51,0.000510965725220667,99811,1.18074113506639
"dedenz",4,0.000201106083459025,21,0.000175437130851037,119701,17,0.000170321908406889,99811,1.18074113506639
"fer",4,0.000201106083459025,21,0.000175437130851037,119701,17,0.000170321908406889,99811,1.18074113506639
"roi",24,0.00120663650075415,127,0.00106097693419437,119701,103,0.00103195038622997,99811,1.1692776289007
"fors",19,0.000955253896430367,101,0.000843769057902607,119701,82,0.000821552734668524,99811,1.1627420323977
"fou",9,0.000452488687782805,48,0.000400999156230942,119701,39,0.000390738495756981,99811,1.15803457477666
"dan",3,0.000150829562594268,16,0.000133666385410314,119701,13,0.000130246165252327,99811,1.15803457477666
"engin",3,0.000150829562594268,16,0.000133666385410314,119701,13,0.000130246165252327,99811,1.15803457477666
"enz",3,0.000150829562594268,16,0.000133666385410314,119701,13,0.000130246165252327,99811,1.15803457477666
"voloir",36,0.00180995475113122,194,0.00162070492310006,119701,158,0.0015829918546052,99811,1.14337590927315
"mettre",15,0.000754147812971342,81,0.000676686076139715,119701,66,0.000661249762050275,99811,1.14048859637095
"ambedos",5,0.000251382604323781,27,0.000225562025379905,119701,22,0.000220416587350092,99811,1.14048859637095
"dire",232,0.0116641528406234,1254,0.0104761029565334,119701,1022,0.0102393523759906,99811,1.13914947081748
"amor",7,0.000351935646053293,38,0.000317457665349496,119701,31,0.000310587009447856,99811,1.13313060542662
"cha",2,0.000100553041729512,11,9.18956399695909e-05,119701,9,9.01704220977648e-05,99811,1.11514440534048
"chape",2,0.000100553041729512,11,9.18956399695909e-05,119701,9,9.01704220977648e-05,99811,1.11514440534048
"gentil",2,0.000100553041729512,11,9.18956399695909e-05,119701,9,9.01704220977648e-05,99811,1.11514440534048
"hanap",2,0.000100553041729512,11,9.18956399695909e-05,119701,9,9.01704220977648e-05,99811,1.11514440534048
"sovent",2,0.000100553041729512,11,9.18956399695909e-05,119701,9,9.01704220977648e-05,99811,1.11514440534048
"près",15,0.000754147812971342,83,0.000693394374316004,119701,68,0.000681287633627556,99811,1.10694481412475
"ouïr",12,0.000603318250377074,67,0.00055972798890569,119701,55,0.000551041468375229,99811,1.09486905251611
"braz",3,0.000150829562594268,17,0.000142020534498459,119701,14,0.000140265101040967,99811,1.07531781943547
"Ifame",3,0.000150829562594268,17,0.000142020534498459,119701,14,0.000140265101040967,99811,1.07531781943547
"prudhomme",3,0.000150829562594268,17,0.000142020534498459,119701,14,0.000140265101040967,99811,1.07531781943547
"sol",8,0.000402212166918049,46,0.000384290858054653,119701,38,0.00038071955996834,99811,1.05645259453309
"laienz",4,0.000201106083459025,23,0.000192145429027326,119701,19,0.00019035977998417,99811,1.05645259453309
"nuit",15,0.000754147812971342,87,0.000726810970668583,119701,72,0.000721363376782118,99811,1.0454478800067
"jour",10,0.000502765208647562,58,0.000484540647112388,119701,48,0.000480908917854745,99811,1.0454478800067
"prisier",5,0.000251382604323781,29,0.000242270323556194,119701,24,0.000240454458927373,99811,1.0454478800067
"pucele",10,0.000502765208647562,59,0.000492894796200533,119701,49,0.000490927853643386,99811,1.02411220898616
"çaienz",3,0.000150829562594268,18,0.000150374683586603,119701,15,0.000150284036829608,99811,1.00362996480644
"restre",3,0.000150829562594268,18,0.000150374683586603,119701,15,0.000150284036829608,99811,1.00362996480644
"fille",11,0.000553041729512318,66,0.000551373839817545,119701,55,0.000551041468375229,99811,1.00362996480644
"ordre",2,0.000100553041729512,12,0.000100249789057736,119701,10,0.000100189357886405,99811,1.00362996480644
"paume",2,0.000100553041729512,12,0.000100249789057736,119701,10,0.000100189357886405,99811,1.00362996480644
"set",2,0.000100553041729512,12,0.000100249789057736,119701,10,0.000100189357886405,99811,1.00362996480644
"quoi",7,0.000351935646053293,43,0.000359228410790219,119701,36,0.000360681688391059,99811,0.975751354672923
"seigneur",11,0.000553041729512318,68,0.000568082137993835,119701,57,0.00057107933995251,99811,0.968414878321999
"anuit",4,0.000201106083459025,25,0.000208853727203616,119701,21,0.000210397651561451,99811,0.955838061720415
"devoir",46,0.00231271995977878,288,0.00240599493738565,119701,242,0.00242458246085101,99811,0.953863189692067
"jor",19,0.000955253896430367,120,0.00100249789057736,119701,101,0.00101191251465269,99811,0.944008382738726
"ui",6,0.000301659125188537,38,0.000317457665349496,119701,32,0.000320605945236497,99811,0.940903092006033
"dieu",14,0.000703871292106586,89,0.000743519268844872,119701,75,0.00075142018414804,99811,0.936721300486006
"devant",19,0.000955253896430367,121,0.0010108520396655,119701,102,0.00102193145044133,99811,0.934753398594229
"vilain",50,0.00251382604323781,321,0.00268168185729443,119701,271,0.00271513159872158,99811,0.925857901112948
"dent",7,0.000351935646053293,45,0.000375936708966508,119701,38,0.00038071955996834,99811,0.924396020216454
"escu",2,0.000100553041729512,13,0.00010860393814588,119701,11,0.000110208293675046,99811,0.912390877096759
"lardier",2,0.000100553041729512,13,0.00010860393814588,119701,11,0.000110208293675046,99811,0.912390877096759
"vieux",6,0.000301659125188537,40,0.000334165963525785,119701,34,0.000340643816813778,99811,0.885555851299796
"compagnon",9,0.000452488687782805,60,0.000501248945288678,119701,51,0.000510965725220667,99811,0.885555851299796
"cuer",15,0.000754147812971342,102,0.000852123206990752,119701,87,0.000871647413611726,99811,0.865198245522789
"chambre",9,0.000452488687782805,62,0.000517957243464967,119701,53,0.000531003596797948,99811,0.852138649363955
"pouvoir",15,0.000754147812971342,104,0.000868831505167041,119701,89,0.000891685285189007,99811,0.84575558832003
"cul",5,0.000251382604323781,35,0.000292395218085062,119701,30,0.000300568073659216,99811,0.836358304005363
"trece",4,0.000201106083459025,28,0.00023391617446805,119701,24,0.000240454458927373,99811,0.836358304005363
"malade",2,0.000100553041729512,14,0.000116958087234025,119701,12,0.000120227229463686,99811,0.836358304005363
"sanc",2,0.000100553041729512,14,0.000116958087234025,119701,12,0.000120227229463686,99811,0.836358304005363
"homme",16,0.000804424333836099,113,0.000944018846960343,119701,97,0.000971836771498131,99811,0.827736053448606
"riche",10,0.000502765208647562,71,0.000593144585258268,119701,61,0.000611155083107072,99811,0.822647512136422
"las",6,0.000301659125188537,43,0.000359228410790219,119701,37,0.0003707006241797,99811,0.813754025518731
"après",15,0.000754147812971342,108,0.00090224810151962,119701,93,0.000931761028343569,99811,0.809379003876158
"bourgeois",11,0.000553041729512318,80,0.00066833192705157,119701,69,0.000691306569416197,99811,0.799994899483391
"chemin",3,0.000150829562594268,22,0.000183791279939182,119701,19,0.00019035977998417,99811,0.792339445899817
"ferir",8,0.000402212166918049,60,0.000501248945288678,119701,52,0.000520984661009308,99811,0.772023049851104
"oste",8,0.000402212166918049,60,0.000501248945288678,119701,52,0.000520984661009308,99811,0.772023049851104
"quant",2,0.000100553041729512,15,0.000125312236322169,119701,13,0.000130246165252327,99811,0.772023049851104
"sus",9,0.000452488687782805,68,0.000568082137993835,119701,59,0.000591117211529791,99811,0.765480481632027
"faire",239,0.0120160884866767,1831,0.0152964469803928,119701,1592,0.0159501457755157,99811,0.753352894436991
"vouloir",33,0.00165912518853695,255,0.00213030801747688,119701,222,0.0022242037450782,99811,0.745941190058837
"nom",8,0.000402212166918049,62,0.000517957243464967,119701,54,0.000541022532586589,99811,0.743429603560323
"frère",9,0.000452488687782805,70,0.000584790436170124,119701,61,0.000611155083107072,99811,0.74038276092278
"feme",27,0.00135746606334842,212,0.00177107960668666,119701,185,0.0018535031208985,99811,0.732378622966858
"cum",3,0.000150829562594268,24,0.000200499578115471,119701,21,0.000210397651561451,99811,0.716878546290311
"ambedeux",2,0.000100553041729512,16,0.000133666385410314,119701,14,0.000140265101040967,99811,0.716878546290311
"battre",2,0.000100553041729512,16,0.000133666385410314,119701,14,0.000140265101040967,99811,0.716878546290311
"dessous",2,0.000100553041729512,16,0.000133666385410314,119701,14,0.000140265101040967,99811,0.716878546290311
"mëisme",2,0.000100553041729512,16,0.000133666385410314,119701,14,0.000140265101040967,99811,0.716878546290311
"recommencer",2,0.000100553041729512,16,0.000133666385410314,119701,14,0.000140265101040967,99811,0.716878546290311
"söef",2,0.000100553041729512,16,0.000133666385410314,119701,14,0.000140265101040967,99811,0.716878546290311
"char",3,0.000150829562594268,25,0.000208853727203616,119701,22,0.000220416587350092,99811,0.68429315782257
"sergent",3,0.000150829562594268,25,0.000208853727203616,119701,22,0.000220416587350092,99811,0.68429315782257
"fortement",5,0.000251382604323781,42,0.000350874261702074,119701,37,0.0003707006241797,99811,0.678128354598943
"être",54,0.00271493212669683,457,0.00381784613328209,119701,403,0.00403763112282213,99811,0.672407172450962
"pöoir",50,0.00251382604323781,425,0.00355051336246147,119701,375,0.0037571009207402,99811,0.66908664320429
"adès",2,0.000100553041729512,17,0.000142020534498459,119701,15,0.000150284036829608,99811,0.66908664320429
"autresi",2,0.000100553041729512,17,0.000142020534498459,119701,15,0.000150284036829608,99811,0.66908664320429
"piere",2,0.000100553041729512,17,0.000142020534498459,119701,15,0.000150284036829608,99811,0.66908664320429
"ça",5,0.000251382604323781,43,0.000359228410790219,119701,38,0.00038071955996834,99811,0.660282871583181
"commencer",9,0.000452488687782805,79,0.000659977777963426,119701,70,0.000701325505204837,99811,0.64519069166128
"entour",3,0.000150829562594268,27,0.000225562025379905,119701,24,0.000240454458927373,99811,0.627268728004022
"uis",10,0.000502765208647562,90,0.000751873417933016,119701,80,0.000801514863091242,99811,0.627268728004022
"ens",4,0.000201106083459025,37,0.000309103516261351,119701,33,0.000330624881025138,99811,0.608260584731173
"fil",3,0.000150829562594268,28,0.00023391617446805,119701,25,0.000250473394716013,99811,0.602177978883861
"cuidier",21,0.00105580693815988,197,0.00164576737036449,119701,176,0.00176333269880073,99811,0.598756513094748
"trois",13,0.00065359477124183,124,0.00103591448692993,119701,111,0.0011121018725391,99811,0.587711240652417
"là",14,0.000703871292106586,135,0.00112781012689952,119701,121,0.0012122912304255,99811,0.580612376334301
"pas",28,0.00140774258421317,274,0.00228903685015163,119701,246,0.00246465820400557,99811,0.571171524686589
"cent",5,0.000251382604323781,49,0.000409353305319087,119701,44,0.000440833174700183,99811,0.570244298185475
"celui",2,0.000100553041729512,20,0.000167082981762893,119701,18,0.00018034084419553,99811,0.557572202670242
"fablïaut",2,0.000100553041729512,20,0.000167082981762893,119701,18,0.00018034084419553,99811,0.557572202670242
"issi",2,0.000100553041729512,20,0.000167082981762893,119701,18,0.00018034084419553,99811,0.557572202670242
"lechëor",2,0.000100553041729512,20,0.000167082981762893,119701,18,0.00018034084419553,99811,0.557572202670242
"Pierre",2,0.000100553041729512,20,0.000167082981762893,119701,18,0.00018034084419553,99811,0.557572202670242
"vache",2,0.000100553041729512,20,0.000167082981762893,119701,18,0.00018034084419553,99811,0.557572202670242
"avugle",1,5.02765208647562e-05,10,8.35414908814463e-05,119701,9,9.01704220977648e-05,99811,0.557572202670242
"cose",1,5.02765208647562e-05,10,8.35414908814463e-05,119701,9,9.01704220977648e-05,99811,0.557572202670242
"felon",1,5.02765208647562e-05,10,8.35414908814463e-05,119701,9,9.01704220977648e-05,99811,0.557572202670242
"mer",1,5.02765208647562e-05,10,8.35414908814463e-05,119701,9,9.01704220977648e-05,99811,0.557572202670242
"mostrer",1,5.02765208647562e-05,10,8.35414908814463e-05,119701,9,9.01704220977648e-05,99811,0.557572202670242
"nëis",1,5.02765208647562e-05,10,8.35414908814463e-05,119701,9,9.01704220977648e-05,99811,0.557572202670242
"soing",1,5.02765208647562e-05,10,8.35414908814463e-05,119701,9,9.01704220977648e-05,99811,0.557572202670242
"trèstous",1,5.02765208647562e-05,10,8.35414908814463e-05,119701,9,9.01704220977648e-05,99811,0.557572202670242
"seignor",50,0.00251382604323781,508,0.00424390773677747,119701,458,0.00458867259119736,99811,0.547832950221853
"comment",11,0.000553041729512318,113,0.000944018846960343,119701,102,0.00102193145044133,99811,0.541173020238764
"prêtre",28,0.00140774258421317,288,0.00240599493738565,119701,260,0.00260492330504654,99811,0.540416134895773
"avoir",330,0.0165912518853695,3482,0.0290891471249196,119701,3152,0.031579685605795,99811,0.525377361018597
"mieux",8,0.000402212166918049,87,0.000726810970668583,119701,79,0.000791495927302602,99811,0.508167070788069
"encore",9,0.000452488687782805,99,0.000827060759726318,119701,90,0.000901704220977648,99811,0.501814982403218
"clore",2,0.000100553041729512,22,0.000183791279939182,119701,20,0.000200378715772811,99811,0.501814982403218
"Ballet",1,5.02765208647562e-05,11,9.18956399695909e-05,119701,10,0.000100189357886405,99811,0.501814982403218
"bras",1,5.02765208647562e-05,11,9.18956399695909e-05,119701,10,0.000100189357886405,99811,0.501814982403218
"chandelle",1,5.02765208647562e-05,11,9.18956399695909e-05,119701,10,0.000100189357886405,99811,0.501814982403218
"fame",1,5.02765208647562e-05,11,9.18956399695909e-05,119701,10,0.000100189357886405,99811,0.501814982403218
"jambe",1,5.02765208647562e-05,11,9.18956399695909e-05,119701,10,0.000100189357886405,99811,0.501814982403218
"langue",1,5.02765208647562e-05,11,9.18956399695909e-05,119701,10,0.000100189357886405,99811,0.501814982403218
"moine",1,5.02765208647562e-05,11,9.18956399695909e-05,119701,10,0.000100189357886405,99811,0.501814982403218
"Robin",1,5.02765208647562e-05,11,9.18956399695909e-05,119701,10,0.000100189357886405,99811,0.501814982403218
"bon",25,0.0012569130216189,278,0.00232245344650421,119701,253,0.00253479075452605,99811,0.495864607117804
"estre",280,0.0140774258421317,3338,0.0278861496562268,119701,3058,0.0306379056416627,99811,0.45947742012067
"clair",1,5.02765208647562e-05,12,0.000100249789057736,119701,11,0.000110208293675046,99811,0.45619543854838
"dessure",1,5.02765208647562e-05,12,0.000100249789057736,119701,11,0.000110208293675046,99811,0.45619543854838
"Gauthier",1,5.02765208647562e-05,12,0.000100249789057736,119701,11,0.000110208293675046,99811,0.45619543854838
"lasus",1,5.02765208647562e-05,12,0.000100249789057736,119701,11,0.000110208293675046,99811,0.45619543854838
"lonc",7,0.000351935646053293,87,0.000726810970668583,119701,80,0.000801514863091242,99811,0.439088109602815
"grand",3,0.000150829562594268,38,0.000317457665349496,119701,35,0.000350662752602419,99811,0.430127127774187
"donc",10,0.000502765208647562,127,0.00106097693419437,119701,117,0.00117221548727094,99811,0.428901694361724
"borjois",3,0.000150829562594268,39,0.00032581181443764,119701,36,0.000360681688391059,99811,0.418179152002681
"eux",3,0.000150829562594268,39,0.00032581181443764,119701,36,0.000360681688391059,99811,0.418179152002681
"siècle",1,5.02765208647562e-05,13,0.00010860393814588,119701,12,0.000120227229463686,99811,0.418179152002681
"nul",18,0.000904977375565611,240,0.00200499578115471,119701,222,0.0022242037450782,99811,0.406877012759366
"mal",19,0.000955253896430367,266,0.00222220365744647,119701,247,0.00247467713979421,99811,0.386011524925552
"bellement",1,5.02765208647562e-05,14,0.000116958087234025,119701,13,0.000130246165252327,99811,0.386011524925552
"çaien",1,5.02765208647562e-05,14,0.000116958087234025,119701,13,0.000130246165252327,99811,0.386011524925552
"fait",1,5.02765208647562e-05,14,0.000116958087234025,119701,13,0.000130246165252327,99811,0.386011524925552
"fils",1,5.02765208647562e-05,14,0.000116958087234025,119701,13,0.000130246165252327,99811,0.386011524925552
"raler",1,5.02765208647562e-05,14,0.000116958087234025,119701,13,0.000130246165252327,99811,0.386011524925552
"bien",61,0.00306686777275013,856,0.0071511516194518,119701,795,0.00796505395196922,99811,0.385040426749639
"femme",6,0.000301659125188537,85,0.000710102672492293,119701,79,0.000791495927302602,99811,0.381125303091051
"jamais",4,0.000201106083459025,58,0.000484540647112388,119701,54,0.000541022532586589,99811,0.371714801780161
"gaire",2,0.000100553041729512,29,0.000242270323556194,119701,27,0.000270511266293294,99811,0.371714801780161
"cuve",1,5.02765208647562e-05,15,0.000125312236322169,119701,14,0.000140265101040967,99811,0.358439273145155
"évêque",1,5.02765208647562e-05,15,0.000125312236322169,119701,14,0.000140265101040967,99811,0.358439273145155
"exemple",1,5.02765208647562e-05,15,0.000125312236322169,119701,14,0.000140265101040967,99811,0.358439273145155
"tel",15,0.000754147812971342,227,0.00189639184300883,119701,212,0.00212401438719179,99811,0.355057770568314
"öil",2,0.000100553041729512,32,0.000267332770820628,119701,30,0.000300568073659216,99811,0.334543321602145
"sous",1,5.02765208647562e-05,16,0.000133666385410314,119701,15,0.000150284036829608,99811,0.334543321602145
"dame",36,0.00180995475113122,585,0.00488717721656461,119701,549,0.00550039574796365,99811,0.329059004854569
"comte",3,0.000150829562594268,50,0.000417707454407231,119701,47,0.000470889982066105,99811,0.320307435576522
"Jean",2,0.000100553041729512,34,0.000284041068996917,119701,32,0.000320605945236497,99811,0.313634364002011
"aï",1,5.02765208647562e-05,17,0.000142020534498459,119701,16,0.000160302972618248,99811,0.313634364002011
"deus",9,0.000452488687782805,156,0.00130324725775056,119701,147,0.00147278356093016,99811,0.307233662695848
"atant",5,0.000251382604323781,88,0.000735165119756727,119701,83,0.000831571670457164,99811,0.302298182170613
"nos",9,0.000452488687782805,162,0.00135337215227943,119701,153,0.001532897175662,99811,0.295185283766599
"asne",2,0.000100553041729512,36,0.000300749367173207,119701,34,0.000340643816813778,99811,0.295185283766599
"peur",1,5.02765208647562e-05,18,0.000150374683586603,119701,17,0.000170321908406889,99811,0.295185283766599
"roncin",1,5.02765208647562e-05,18,0.000150374683586603,119701,17,0.000170321908406889,99811,0.295185283766599
"Huet",1,5.02765208647562e-05,19,0.000158728832674748,119701,18,0.00018034084419553,99811,0.278786101335121
"tiers",1,5.02765208647562e-05,19,0.000158728832674748,119701,18,0.00018034084419553,99811,0.278786101335121
"trente",1,5.02765208647562e-05,19,0.000158728832674748,119701,18,0.00018034084419553,99811,0.278786101335121
"ainsi",8,0.000402212166918049,157,0.00131160140683871,119701,149,0.00149282143250744,99811,0.269430863035285
"ains",4,0.000201106083459025,79,0.000659977777963426,119701,75,0.00075142018414804,99811,0.267634657281716
"beau",3,0.000150829562594268,62,0.000517957243464967,119701,59,0.000591117211529791,99811,0.255160160544009
"ton",4,0.000201106083459025,85,0.000710102672492293,119701,81,0.000811533798879883,99811,0.247809867853441
"doux",2,0.000100553041729512,43,0.000359228410790219,119701,41,0.000410776367334262,99811,0.244787796294253
"tu",19,0.000955253896430367,437,0.0036507631515192,119701,418,0.00418791515965174,99811,0.22809771927419
"tantôt",2,0.000100553041729512,48,0.000400999156230942,119701,46,0.000460871046277464,99811,0.218180427131834
"sac",1,5.02765208647562e-05,25,0.000208853727203616,119701,24,0.000240454458927373,99811,0.209089576001341
"tant",20,0.00100553041729512,506,0.00422719943860118,119701,486,0.0048692027932793,99811,0.206508223211201
"tous",3,0.000150829562594268,76,0.000634915330698992,119701,73,0.000731382312570759,99811,0.206225335234199
"Idone",1,5.02765208647562e-05,26,0.00021720787629176,119701,25,0.000250473394716013,99811,0.200725992961287
"moigne",2,0.000100553041729512,53,0.000442769901671665,119701,51,0.000510965725220667,99811,0.196790189177732
"ha",1,5.02765208647562e-05,27,0.000225562025379905,119701,26,0.000260492330504654,99811,0.193005762462776
"come",13,0.00065359477124183,356,0.00297407707537949,119701,343,0.0034364949755037,99811,0.190192267383144
"mon",22,0.00110608345902464,606,0.00506261434741564,119701,584,0.00585105850056607,99811,0.189039890631349
"peu",3,0.000150829562594268,83,0.000693394374316004,119701,80,0.000801514863091242,99811,0.188180618401207
"trèstout",1,5.02765208647562e-05,28,0.00023391617446805,119701,27,0.000270511266293294,99811,0.185857400890081
"saint",7,0.000351935646053293,197,0.00164576737036449,119701,190,0.0019035977998417,99811,0.184879204043291
"tout",10,0.000502765208647562,285,0.00238093249012122,119701,275,0.00275520734187615,99811,0.182478175419352
"chacun",1,5.02765208647562e-05,29,0.000242270323556194,119701,28,0.000280530202081935,99811,0.179219636572578
"onque",5,0.000251382604323781,148,0.0012364140650454,119701,143,0.0014327078177756,99811,0.175459784057069
"barat",1,5.02765208647562e-05,30,0.000250624472644339,119701,29,0.000290549137870575,99811,0.173039649104558
"robe",1,5.02765208647562e-05,30,0.000250624472644339,119701,29,0.000290549137870575,99811,0.173039649104558
"notre",3,0.000150829562594268,91,0.000760227567021161,119701,88,0.000881666349400367,99811,0.171073289455642
"Dieu",10,0.000502765208647562,305,0.00254801547188411,119701,295,0.00295558605764896,99811,0.170106773696006
"vers",3,0.000150829562594268,93,0.00077693586519745,119701,90,0.000901704220977648,99811,0.167271660801073
"ainçois",2,0.000100553041729512,62,0.000517957243464967,119701,60,0.000601136147318432,99811,0.167271660801073
"adonc",1,5.02765208647562e-05,31,0.000258978621732483,119701,30,0.000300568073659216,99811,0.167271660801073
"vostre",7,0.000351935646053293,225,0.00187968354483254,119701,218,0.00218412800192364,99811,0.161133251230391
"plus",13,0.00065359477124183,445,0.00371759634422436,119701,432,0.00432818026069271,99811,0.151009138223191
"or",14,0.000703871292106586,494,0.00412694964954345,119701,480,0.00480908917854745,99811,0.146362703200938
"aussi",1,5.02765208647562e-05,37,0.000309103516261351,119701,36,0.000360681688391059,99811,0.13939305066756
"lors",5,0.000251382604323781,192,0.00160399662492377,119701,187,0.00187354099247578,99811,0.134175128984818
"autre",7,0.000351935646053293,272,0.00227232855197534,119701,265,0.00265501798398974,99811,0.132554901012171
"tost",3,0.000150829562594268,119,0.000994143741489211,119701,116,0.0011621965514823,99811,0.129779736828418
"cel",17,0.000854700854700855,719,0.00600663319437599,119701,702,0.00703329292362565,99811,0.121522146735822
"lez",1,5.02765208647562e-05,43,0.000359228410790219,119701,42,0.000420795303122902,99811,0.119479757715052
"valet",1,5.02765208647562e-05,43,0.000359228410790219,119701,42,0.000420795303122902,99811,0.119479757715052
"pour",2,0.000100553041729512,89,0.000743519268844872,119701,87,0.000871647413611726,99811,0.115359766069705
"mais",15,0.000754147812971342,671,0.00560563403814504,119701,656,0.00657242187734819,99811,0.114744279512931
"on",5,0.000251382604323781,230,0.00192145429027326,119701,225,0.00225426055244412,99811,0.111514440534048
"je",49,0.00246354952237305,2375,0.0198411040843435,119701,2326,0.0233040446443779,99811,0.105713388382449
"très",1,5.02765208647562e-05,49,0.000409353305319087,119701,48,0.000480908917854745,99811,0.10454478800067
"tot",11,0.000553041729512318,542,0.00452794880577439,119701,531,0.00532005490376812,99811,0.103954139480893
"puis",7,0.000351935646053293,350,0.00292395218085062,119701,343,0.0034364949755037,99811,0.102411220898616
"clerc",2,0.000100553041729512,109,0.000910602250607764,119701,107,0.00107202612938454,99811,0.0937971929725641
"mout",2,0.000100553041729512,119,0.000994143741489211,119701,117,0.00117221548727094,99811,0.0857803388723449
"ja",5,0.000251382604323781,299,0.00249789057735524,119701,294,0.00294556712186032,99811,0.0853426840821799
"certes",1,5.02765208647562e-05,61,0.000509603094376822,119701,60,0.000601136147318432,99811,0.0836358304005363
"elle",1,5.02765208647562e-05,61,0.000509603094376822,119701,60,0.000601136147318432,99811,0.0836358304005363
"vos",15,0.000754147812971342,928,0.00775265035379821,119701,913,0.0091472883750288,99811,0.0824449587738036
"vous",6,0.000301659125188537,438,0.00365911730060735,119701,432,0.00432818026069271,99811,0.0696965253337802
"entre",1,5.02765208647562e-05,76,0.000634915330698992,119701,75,0.00075142018414804,99811,0.066908664320429
"grant",7,0.000351935646053293,538,0.00449453220942181,119701,531,0.00532005490376812,99811,0.0661526342151134
"sor",2,0.000100553041729512,155,0.00129489310866242,119701,153,0.001532897175662,99811,0.0655967297259108
"quel",1,5.02765208647562e-05,79,0.000659977777963426,119701,78,0.000781476991513961,99811,0.0643352541542587
"dont",2,0.000100553041729512,194,0.00162070492310006,119701,192,0.00192363567141898,99811,0.0522723940003352
"maint",1,5.02765208647562e-05,97,0.000810352461550029,119701,96,0.000961817835709491,99811,0.0522723940003352
"il",63,0.00316742081447964,6220,0.0519628073282596,119701,6157,0.0616865876506597,99811,0.0513469934893661
"soi",14,0.000703871292106586,1384,0.0115621423379922,119701,1370,0.0137259420304375,99811,0.0512803631652923
"son",16,0.000804424333836099,1788,0.0149372185696026,119701,1772,0.017753554217471,99811,0.0453106078919384
"cest",2,0.000100553041729512,233,0.0019465167375377,119701,231,0.00231437416717596,99811,0.0434471846236552
"chascun",1,5.02765208647562e-05,123,0.00102756033784179,119701,122,0.00122231016621414,99811,0.0411323756068211
"o",1,5.02765208647562e-05,215,0.00179614205395109,119701,214,0.00214405225876907,99811,0.023449298243141
"un",6,0.000301659125188537,1331,0.0111193724363205,119701,1325,0.0132750899199487,99811,0.0227236973163721
"cil",1,5.02765208647562e-05,234,0.00195487088662584,119701,233,0.00233441203875324,99811,0.0215371237082926
"moult",2,0.000100553041729512,738,0.00616536202705073,119701,736,0.00737393674043943,99811,0.0136362766957396
"en",5,0.000251382604323781,2760,0.0230574514832792,119701,2755,0.0276021680977047,99811,0.00910734995287146
"que",6,0.000301659125188537,4998,0.0417540371425468,119701,4992,0.0500145274568935,99811,0.00603143007696175
"si",2,0.000100553041729512,1711,0.0142939490898155,119701,1709,0.0171223612627867,99811,0.00587261535872695
"a",3,0.000150829562594268,2578,0.0215369963492368,119701,2575,0.0257987596557494,99811,0.00584638814450351
"et",2,0.000100553041729512,3946,0.0329654723018187,119701,3944,0.0395146827503983,99811,0.00254470072212585
"ne",1,5.02765208647562e-05,3218,0.0268836517656494,119701,3217,0.0322309164320566,99811,0.00155988493131246
"le",1,5.02765208647562e-05,6025,0.0503337482560714,119701,6024,0.0603540691907706,99811,0.000833026199208529
