"lemma","count_final","rate_final","count_all","rate_all","vs_all","count_not_final","rate_not_final","vs_not_final","diff_rates"
"agreer",13,0.00110516024823599,13,0.000126757542073753,102558,0,0,90795,Inf
"embraser",12,0.00102014792144861,12,0.000117006961914234,102558,0,0,90795,Inf
"demeurée",11,0.000935135594661226,11,0.000107256381754714,102558,0,0,90795,Inf
"droiturier",10,0.000850123267873842,10,9.75058015951949e-05,102558,0,0,90795,Inf
"passion",11,0.000935135594661226,12,0.000117006961914234,102558,1,1.10138223470455e-05,90795,84.905636317266
"débonnairement",10,0.000850123267873842,11,0.000107256381754714,102558,1,1.10138223470455e-05,90795,77.1869421066055
"lumière",10,0.000850123267873842,11,0.000107256381754714,102558,1,1.10138223470455e-05,90795,77.1869421066055
"renommée",10,0.000850123267873842,11,0.000107256381754714,102558,1,1.10138223470455e-05,90795,77.1869421066055
"targer",10,0.000850123267873842,11,0.000107256381754714,102558,1,1.10138223470455e-05,90795,77.1869421066055
"oublier",9,0.000765110941086458,10,9.75058015951949e-05,102558,1,1.10138223470455e-05,90795,69.4682478959449
"honorer",17,0.00144520955538553,19,0.00018526102303087,102558,2,2.20276446940911e-05,90795,65.6089007906146
"contraire",10,0.000850123267873842,12,0.000117006961914234,102558,2,2.20276446940911e-05,90795,38.5934710533027
"droiture",10,0.000850123267873842,12,0.000117006961914234,102558,2,2.20276446940911e-05,90795,38.5934710533027
"vis",10,0.000850123267873842,12,0.000117006961914234,102558,2,2.20276446940911e-05,90795,38.5934710533027
"folie",19,0.0016152342089603,23,0.000224263343668948,102558,4,4.40552893881822e-05,90795,36.6637975006376
"retraire",19,0.0016152342089603,23,0.000224263343668948,102558,4,4.40552893881822e-05,90795,36.6637975006376
"saisir",14,0.00119017257502338,17,0.000165759862711831,102558,3,3.30414670411366e-05,90795,36.0205729830826
"prouver",9,0.000765110941086458,11,0.000107256381754714,102558,2,2.20276446940911e-05,90795,34.7341239479725
"remüer",9,0.000765110941086458,11,0.000107256381754714,102558,2,2.20276446940911e-05,90795,34.7341239479725
"courage",16,0.00136019722859815,20,0.00019501160319039,102558,4,4.40552893881822e-05,90795,30.8747768426422
"choisir",8,0.000680098614299073,10,9.75058015951949e-05,102558,2,2.20276446940911e-05,90795,30.8747768426422
"pensée",25,0.0021253081696846,32,0.000312018565104624,102558,7,7.70967564293188e-05,90795,27.5667650380734
"envie",14,0.00119017257502338,18,0.000175510442871351,102558,4,4.40552893881822e-05,90795,27.0154297373119
"ébahir",24,0.00204029584289722,31,0.000302267984945104,102558,7,7.70967564293188e-05,90795,26.4640944365504
"tendre",10,0.000850123267873842,13,0.000126757542073753,102558,3,3.30414670411366e-05,90795,25.7289807022018
"respit",13,0.00110516024823599,17,0.000165759862711831,102558,4,4.40552893881822e-05,90795,25.0857561846468
"esgarder",9,0.000765110941086458,12,0.000117006961914234,102558,3,3.30414670411366e-05,90795,23.1560826319816
"poissant",25,0.0021253081696846,34,0.000331519725423663,102558,9,9.91244011234099e-05,90795,21.4408172518349
"appareiller",11,0.000935135594661226,15,0.000146258702392792,102558,4,4.40552893881822e-05,90795,21.2264090793165
"largement",8,0.000680098614299073,11,0.000107256381754714,102558,3,3.30414670411366e-05,90795,20.5831845617615
"nature",13,0.00110516024823599,18,0.000175510442871351,102558,5,5.50691117352277e-05,90795,20.0686049477174
"compagnie",25,0.0021253081696846,35,0.000341270305583182,102558,10,0.000110138223470455,90795,19.2967355266514
"bonnement",10,0.000850123267873842,14,0.000136508122233273,102558,4,4.40552893881822e-05,90795,19.2967355266514
"deviser",10,0.000850123267873842,14,0.000136508122233273,102558,4,4.40552893881822e-05,90795,19.2967355266514
"débonnaire",14,0.00119017257502338,20,0.00019501160319039,102558,6,6.60829340822732e-05,90795,18.0102864915413
"departir",14,0.00119017257502338,20,0.00019501160319039,102558,6,6.60829340822732e-05,90795,18.0102864915413
"doter",7,0.000595086287511689,10,9.75058015951949e-05,102558,3,3.30414670411366e-05,90795,18.0102864915413
"ennui",7,0.000595086287511689,10,9.75058015951949e-05,102558,3,3.30414670411366e-05,90795,18.0102864915413
"fondre",7,0.000595086287511689,10,9.75058015951949e-05,102558,3,3.30414670411366e-05,90795,18.0102864915413
"réjouir",7,0.000595086287511689,10,9.75058015951949e-05,102558,3,3.30414670411366e-05,90795,18.0102864915413
"celer",16,0.00136019722859815,23,0.000224263343668948,102558,7,7.70967564293188e-05,90795,17.642729624367
"partie",18,0.00153022188217292,26,0.000253515084147507,102558,8,8.81105787763643e-05,90795,17.3670619739862
"esbäir",9,0.000765110941086458,13,0.000126757542073753,102558,4,4.40552893881822e-05,90795,17.3670619739862
"naistre",35,0.00297543143755845,51,0.000497279588135494,102558,16,0.000176221157552729,90795,16.8846435858199
"atendre",13,0.00110516024823599,19,0.00018526102303087,102558,6,6.60829340822732e-05,90795,16.7238374564312
"cure",15,0.00127518490181076,22,0.000214512763509429,102558,7,7.70967564293188e-05,90795,16.540059022844
"tourmenter",19,0.0016152342089603,28,0.000273016244466546,102558,9,9.91244011234099e-05,90795,16.2950211113945
"vraiment",14,0.00119017257502338,21,0.000204762183349909,102558,7,7.70967564293188e-05,90795,15.4373884213211
"aporter",10,0.000850123267873842,15,0.000146258702392792,102558,5,5.50691117352277e-05,90795,15.4373884213211
"étendre",8,0.000680098614299073,12,0.000117006961914234,102558,4,4.40552893881822e-05,90795,15.4373884213211
"sauvage",8,0.000680098614299073,12,0.000117006961914234,102558,4,4.40552893881822e-05,90795,15.4373884213211
"journée",19,0.0016152342089603,29,0.000282766824626065,102558,10,0.000110138223470455,90795,14.665519000255
"aviser",13,0.00110516024823599,20,0.00019501160319039,102558,7,7.70967564293188e-05,90795,14.3347178197982
"aventure",11,0.000935135594661226,17,0.000165759862711831,102558,6,6.60829340822732e-05,90795,14.150939386211
"défendre",11,0.000935135594661226,17,0.000165759862711831,102558,6,6.60829340822732e-05,90795,14.150939386211
"présent",11,0.000935135594661226,17,0.000165759862711831,102558,6,6.60829340822732e-05,90795,14.150939386211
"afaire",9,0.000765110941086458,14,0.000136508122233273,102558,5,5.50691117352277e-05,90795,13.893649579189
"souverain",9,0.000765110941086458,14,0.000136508122233273,102558,5,5.50691117352277e-05,90795,13.893649579189
"taire",14,0.00119017257502338,22,0.000214512763509429,102558,8,8.81105787763643e-05,90795,13.507714868656
"former",7,0.000595086287511689,11,0.000107256381754714,102558,4,4.40552893881822e-05,90795,13.507714868656
"pur",7,0.000595086287511689,11,0.000107256381754714,102558,4,4.40552893881822e-05,90795,13.507714868656
"plaisir",17,0.00144520955538553,27,0.000263265664307026,102558,10,0.000110138223470455,90795,13.1217801581229
"épouser",10,0.000850123267873842,16,0.000156009282552312,102558,6,6.60829340822732e-05,90795,12.8644903511009
"mie",66,0.00561081356796736,106,0.00103356149690907,102558,40,0.000440552893881822,90795,12.7358454475899
"matiere",13,0.00110516024823599,21,0.000204762183349909,102558,8,8.81105787763643e-05,90795,12.5428780923234
"mentir",21,0.00178525886253507,34,0.000331519725423663,102558,13,0.000143179690511592,90795,12.4686598787593
"clamer",16,0.00136019722859815,26,0.000253515084147507,102558,10,0.000110138223470455,90795,12.3499107370569
"accorder",8,0.000680098614299073,13,0.000126757542073753,102558,5,5.50691117352277e-05,90795,12.3499107370569
"chiere",11,0.000935135594661226,18,0.000175510442871351,102558,7,7.70967564293188e-05,90795,12.1293766167523
"remanoir",11,0.000935135594661226,18,0.000175510442871351,102558,7,7.70967564293188e-05,90795,12.1293766167523
"entier",17,0.00144520955538553,28,0.000273016244466546,102558,11,0.000121152045817501,90795,11.928891052839
"fier",9,0.000765110941086458,15,0.000146258702392792,102558,6,6.60829340822732e-05,90795,11.5780413159908
"mari",9,0.000765110941086458,15,0.000146258702392792,102558,6,6.60829340822732e-05,90795,11.5780413159908
"vain",9,0.000765110941086458,15,0.000146258702392792,102558,6,6.60829340822732e-05,90795,11.5780413159908
"confesser",6,0.000510073960724305,10,9.75058015951949e-05,102558,4,4.40552893881822e-05,90795,11.5780413159908
"confort",6,0.000510073960724305,10,9.75058015951949e-05,102558,4,4.40552893881822e-05,90795,11.5780413159908
"eschaper",6,0.000510073960724305,10,9.75058015951949e-05,102558,4,4.40552893881822e-05,90795,11.5780413159908
"guerpir",6,0.000510073960724305,10,9.75058015951949e-05,102558,4,4.40552893881822e-05,90795,11.5780413159908
"honnir",6,0.000510073960724305,10,9.75058015951949e-05,102558,4,4.40552893881822e-05,90795,11.5780413159908
"livrer",6,0.000510073960724305,10,9.75058015951949e-05,102558,4,4.40552893881822e-05,90795,11.5780413159908
"ordonner",6,0.000510073960724305,10,9.75058015951949e-05,102558,4,4.40552893881822e-05,90795,11.5780413159908
"plenté",6,0.000510073960724305,10,9.75058015951949e-05,102558,4,4.40552893881822e-05,90795,11.5780413159908
"sauvement",6,0.000510073960724305,10,9.75058015951949e-05,102558,4,4.40552893881822e-05,90795,11.5780413159908
"tramettre",6,0.000510073960724305,10,9.75058015951949e-05,102558,4,4.40552893881822e-05,90795,11.5780413159908
"travailler",6,0.000510073960724305,10,9.75058015951949e-05,102558,4,4.40552893881822e-05,90795,11.5780413159908
"coucher",13,0.00110516024823599,22,0.000214512763509429,102558,9,9.91244011234099e-05,90795,11.1492249709541
"contree",20,0.00170024653574768,34,0.000331519725423663,102558,14,0.000154193512858638,90795,11.0267060152294
"dolor",10,0.000850123267873842,17,0.000165759862711831,102558,7,7.70967564293188e-05,90795,11.0267060152294
"äie",7,0.000595086287511689,12,0.000117006961914234,102558,5,5.50691117352277e-05,90795,10.8061718949248
"sonner",7,0.000595086287511689,12,0.000117006961914234,102558,5,5.50691117352277e-05,90795,10.8061718949248
"visage",7,0.000595086287511689,12,0.000117006961914234,102558,5,5.50691117352277e-05,90795,10.8061718949248
"pendre",18,0.00153022188217292,31,0.000302267984945104,102558,13,0.000143179690511592,90795,10.6874227532223
"néant",12,0.00102014792144861,21,0.000204762183349909,102558,9,9.91244011234099e-05,90795,10.2915922808807
"appeler",26,0.00221032049647199,46,0.000448526687337897,102558,20,0.000220276446940911,90795,10.0343024738587
"Marie",31,0.00263538213040891,55,0.000536281908773572,102558,24,0.000264331736329093,90795,9.96998002210321
"aimer",18,0.00153022188217292,32,0.000312018565104624,102558,14,0.000154193512858638,90795,9.92403541370641
"assembler",14,0.00119017257502338,25,0.000243764503987987,102558,11,0.000121152045817501,90795,9.82379263174979
"bonté",11,0.000935135594661226,20,0.00019501160319039,102558,9,9.91244011234099e-05,90795,9.43395959080734
"attendre",12,0.00102014792144861,22,0.000214512763509429,102558,10,0.000110138223470455,90795,9.26243305279266
"costé",6,0.000510073960724305,11,0.000107256381754714,102558,5,5.50691117352277e-05,90795,9.26243305279266
"douceur",6,0.000510073960724305,11,0.000107256381754714,102558,5,5.50691117352277e-05,90795,9.26243305279266
"jugement",6,0.000510073960724305,11,0.000107256381754714,102558,5,5.50691117352277e-05,90795,9.26243305279266
"raconter",6,0.000510073960724305,11,0.000107256381754714,102558,5,5.50691117352277e-05,90795,9.26243305279266
"grever",7,0.000595086287511689,13,0.000126757542073753,102558,6,6.60829340822732e-05,90795,9.00514324577064
"endormir",10,0.000850123267873842,19,0.00018526102303087,102558,9,9.91244011234099e-05,90795,8.57632690073394
"envoiier",10,0.000850123267873842,19,0.00018526102303087,102558,9,9.91244011234099e-05,90795,8.57632690073394
"demener",11,0.000935135594661226,21,0.000204762183349909,102558,10,0.000110138223470455,90795,8.4905636317266
"torner",11,0.000935135594661226,21,0.000204762183349909,102558,10,0.000110138223470455,90795,8.4905636317266
"tourment",25,0.0021253081696846,48,0.000468027847656936,102558,23,0.000253317913982047,90795,8.38988501158755
"octroyer",13,0.00110516024823599,25,0.000243764503987987,102558,12,0.000132165868164546,90795,8.36191872821559
"volonté",15,0.00127518490181076,29,0.000282766824626065,102558,14,0.000154193512858638,90795,8.27002951142201
"demander",31,0.00263538213040891,60,0.000585034809571169,102558,29,0.000319400848064321,90795,8.25101794932679
"dolent",17,0.00144520955538553,33,0.000321769145264143,102558,16,0.000176221157552729,90795,8.20111259882683
"conter",38,0.0032304684179206,74,0.000721542931804442,102558,36,0.000396497604493639,90795,8.14751055569724
"lever",28,0.00238034515004676,56,0.000546032488933092,102558,28,0.000308387025717275,90795,7.71869421066055
"nourrir",16,0.00136019722859815,32,0.000312018565104624,102558,16,0.000176221157552729,90795,7.71869421066055
"lié",14,0.00119017257502338,28,0.000273016244466546,102558,14,0.000154193512858638,90795,7.71869421066055
"tenter",14,0.00119017257502338,28,0.000273016244466546,102558,14,0.000154193512858638,90795,7.71869421066055
"escouter",12,0.00102014792144861,24,0.000234013923828468,102558,12,0.000132165868164546,90795,7.71869421066055
"trépasser",12,0.00102014792144861,24,0.000234013923828468,102558,12,0.000132165868164546,90795,7.71869421066055
"voie",12,0.00102014792144861,24,0.000234013923828468,102558,12,0.000132165868164546,90795,7.71869421066055
"desservir",10,0.000850123267873842,20,0.00019501160319039,102558,10,0.000110138223470455,90795,7.71869421066055
"finer",9,0.000765110941086458,18,0.000175510442871351,102558,9,9.91244011234099e-05,90795,7.71869421066055
"Normandie",9,0.000765110941086458,18,0.000175510442871351,102558,9,9.91244011234099e-05,90795,7.71869421066055
"reposer",9,0.000765110941086458,18,0.000175510442871351,102558,9,9.91244011234099e-05,90795,7.71869421066055
"arriver",8,0.000680098614299073,16,0.000156009282552312,102558,8,8.81105787763643e-05,90795,7.71869421066055
"ovrer",8,0.000680098614299073,16,0.000156009282552312,102558,8,8.81105787763643e-05,90795,7.71869421066055
"avenir",7,0.000595086287511689,14,0.000136508122233273,102558,7,7.70967564293188e-05,90795,7.71869421066055
"avis",7,0.000595086287511689,14,0.000136508122233273,102558,7,7.70967564293188e-05,90795,7.71869421066055
"baptiser",7,0.000595086287511689,14,0.000136508122233273,102558,7,7.70967564293188e-05,90795,7.71869421066055
"commandement",6,0.000510073960724305,12,0.000117006961914234,102558,6,6.60829340822732e-05,90795,7.71869421066055
"durer",6,0.000510073960724305,12,0.000117006961914234,102558,6,6.60829340822732e-05,90795,7.71869421066055
"férir",6,0.000510073960724305,12,0.000117006961914234,102558,6,6.60829340822732e-05,90795,7.71869421066055
"müer",6,0.000510073960724305,12,0.000117006961914234,102558,6,6.60829340822732e-05,90795,7.71869421066055
"obéir",6,0.000510073960724305,12,0.000117006961914234,102558,6,6.60829340822732e-05,90795,7.71869421066055
"pardon",6,0.000510073960724305,12,0.000117006961914234,102558,6,6.60829340822732e-05,90795,7.71869421066055
"semblant",6,0.000510073960724305,12,0.000117006961914234,102558,6,6.60829340822732e-05,90795,7.71869421066055
"braire",5,0.000425061633936921,10,9.75058015951949e-05,102558,5,5.50691117352277e-05,90795,7.71869421066055
"di",5,0.000425061633936921,10,9.75058015951949e-05,102558,5,5.50691117352277e-05,90795,7.71869421066055
"facon",5,0.000425061633936921,10,9.75058015951949e-05,102558,5,5.50691117352277e-05,90795,7.71869421066055
"lignée",5,0.000425061633936921,10,9.75058015951949e-05,102558,5,5.50691117352277e-05,90795,7.71869421066055
"louer",5,0.000425061633936921,10,9.75058015951949e-05,102558,5,5.50691117352277e-05,90795,7.71869421066055
"puant",5,0.000425061633936921,10,9.75058015951949e-05,102558,5,5.50691117352277e-05,90795,7.71869421066055
"seignier",5,0.000425061633936921,10,9.75058015951949e-05,102558,5,5.50691117352277e-05,90795,7.71869421066055
"service",5,0.000425061633936921,10,9.75058015951949e-05,102558,5,5.50691117352277e-05,90795,7.71869421066055
"tuer",5,0.000425061633936921,10,9.75058015951949e-05,102558,5,5.50691117352277e-05,90795,7.71869421066055
"manière",20,0.00170024653574768,41,0.000399773786540299,102558,21,0.000231290269287956,90795,7.35113734348623
"sage",18,0.00153022188217292,37,0.000360771465902221,102558,19,0.000209262624593865,90795,7.31244714694157
"raison",33,0.00280540678398368,68,0.000663039450847325,102558,35,0.000385483782146594,90795,7.27762597005137
"demeurer",47,0.00399557935900706,97,0.000945806275473391,102558,50,0.000550691117352277,90795,7.25557255802091
"tourner",15,0.00127518490181076,31,0.000302267984945104,102558,16,0.000176221157552729,90795,7.23627582249426
"aorer",10,0.000850123267873842,21,0.000204762183349909,102558,11,0.000121152045817501,90795,7.01699473696413
"aprendre",10,0.000850123267873842,21,0.000204762183349909,102558,11,0.000121152045817501,90795,7.01699473696413
"départir",10,0.000850123267873842,21,0.000204762183349909,102558,11,0.000121152045817501,90795,7.01699473696413
"martire",10,0.000850123267873842,21,0.000204762183349909,102558,11,0.000121152045817501,90795,7.01699473696413
"pardonner",10,0.000850123267873842,21,0.000204762183349909,102558,11,0.000121152045817501,90795,7.01699473696413
"écriture",9,0.000765110941086458,19,0.00018526102303087,102558,10,0.000110138223470455,90795,6.94682478959449
"vilain",9,0.000765110941086458,19,0.00018526102303087,102558,10,0.000110138223470455,90795,6.94682478959449
"talent",16,0.00136019722859815,34,0.000331519725423663,102558,18,0.00019824880224682,90795,6.86106152058715
"cesser",8,0.000680098614299073,17,0.000165759862711831,102558,9,9.91244011234099e-05,90795,6.86106152058715
"déprier",8,0.000680098614299073,17,0.000165759862711831,102558,9,9.91244011234099e-05,90795,6.86106152058715
"chanter",15,0.00127518490181076,32,0.000312018565104624,102558,17,0.000187234979899774,90795,6.81061253881813
"ester",7,0.000595086287511689,15,0.000146258702392792,102558,8,8.81105787763643e-05,90795,6.75385743432798
"poissance",7,0.000595086287511689,15,0.000146258702392792,102558,8,8.81105787763643e-05,90795,6.75385743432798
"merci",25,0.0021253081696846,54,0.000526531328614053,102558,29,0.000319400848064321,90795,6.65404673332806
"bailler",6,0.000510073960724305,13,0.000126757542073753,102558,7,7.70967564293188e-05,90795,6.61602360913761
"dévotement",6,0.000510073960724305,13,0.000126757542073753,102558,7,7.70967564293188e-05,90795,6.61602360913761
"lez",6,0.000510073960724305,13,0.000126757542073753,102558,7,7.70967564293188e-05,90795,6.61602360913761
"amener",18,0.00153022188217292,39,0.00038027262622126,102558,21,0.000231290269287956,90795,6.61602360913761
"douleur",18,0.00153022188217292,39,0.00038027262622126,102558,21,0.000231290269287956,90795,6.61602360913761
"sauver",11,0.000935135594661226,24,0.000234013923828468,102558,13,0.000143179690511592,90795,6.53120279363585
"regarder",37,0.00314545609113321,81,0.000789796992921079,102558,44,0.000484608183270004,90795,6.49072013169182
"ami",71,0.00603587520190428,156,0.00152109050488504,102558,85,0.000936174899498871,90795,6.44737987008116
"accomplir",5,0.000425061633936921,11,0.000107256381754714,102558,6,6.60829340822732e-05,90795,6.43224517555046
"soupirer",5,0.000425061633936921,11,0.000107256381754714,102558,6,6.60829340822732e-05,90795,6.43224517555046
"maison",14,0.00119017257502338,31,0.000302267984945104,102558,17,0.000187234979899774,90795,6.35657170289692
"assëoir",9,0.000765110941086458,20,0.00019501160319039,102558,11,0.000121152045817501,90795,6.31529526326772
"maintenir",9,0.000765110941086458,20,0.00019501160319039,102558,11,0.000121152045817501,90795,6.31529526326772
"mener",55,0.00467567797330613,123,0.0011993213596209,102558,68,0.000748939919599097,90795,6.24306149391662
"passer",24,0.00204029584289722,54,0.000526531328614053,102558,30,0.000330414670411366,90795,6.17495536852844
"chrétienté",8,0.000680098614299073,18,0.000175510442871351,102558,10,0.000110138223470455,90795,6.17495536852844
"couchier",15,0.00127518490181076,34,0.000331519725423663,102558,19,0.000209262624593865,90795,6.09370595578464
"écrire",15,0.00127518490181076,34,0.000331519725423663,102558,19,0.000209262624593865,90795,6.09370595578464
"aidier",7,0.000595086287511689,16,0.000156009282552312,102558,9,9.91244011234099e-05,90795,6.00342883051376
"plorer",7,0.000595086287511689,16,0.000156009282552312,102558,9,9.91244011234099e-05,90795,6.00342883051376
"vie",65,0.00552580124117997,149,0.0014528364437684,102558,84,0.000925161077151826,90795,5.97279909158256
"clair",10,0.000850123267873842,23,0.000224263343668948,102558,13,0.000143179690511592,90795,5.9374570851235
"prisier",10,0.000850123267873842,23,0.000224263343668948,102558,13,0.000143179690511592,90795,5.9374570851235
"vestir",10,0.000850123267873842,23,0.000224263343668948,102558,13,0.000143179690511592,90795,5.9374570851235
"porter",48,0.00408059168579444,111,0.00108231439770666,102558,63,0.000693870807863869,90795,5.88090987478899
"monter",16,0.00136019722859815,37,0.000360771465902221,102558,21,0.000231290269287956,90795,5.88090987478899
"amer",43,0.00365553005185752,100,0.000975058015951949,102558,57,0.000627787873781596,90795,5.82287457997199
"descendre",15,0.00127518490181076,35,0.000341270305583182,102558,20,0.000220276446940911,90795,5.78902065799541
"embattre",6,0.000510073960724305,14,0.000136508122233273,102558,8,8.81105787763643e-05,90795,5.78902065799541
"guérir",6,0.000510073960724305,14,0.000136508122233273,102558,8,8.81105787763643e-05,90795,5.78902065799541
"guerre",6,0.000510073960724305,14,0.000136508122233273,102558,8,8.81105787763643e-05,90795,5.78902065799541
"humilité",6,0.000510073960724305,14,0.000136508122233273,102558,8,8.81105787763643e-05,90795,5.78902065799541
"parler",63,0.0053557765876052,148,0.00144308586360888,102558,85,0.000936174899498871,90795,5.72091453260723
"errer",11,0.000935135594661226,26,0.000253515084147507,102558,15,0.000165207335205683,90795,5.6603757544844
"naître",11,0.000935135594661226,26,0.000253515084147507,102558,15,0.000165207335205683,90795,5.6603757544844
"nommer",24,0.00204029584289722,57,0.000555783069092611,102558,33,0.000363456137452503,90795,5.61359578957131
"foison",5,0.000425061633936921,12,0.000117006961914234,102558,7,7.70967564293188e-05,90795,5.51335300761468
"menu",5,0.000425061633936921,12,0.000117006961914234,102558,7,7.70967564293188e-05,90795,5.51335300761468
"ouvrir",5,0.000425061633936921,12,0.000117006961914234,102558,7,7.70967564293188e-05,90795,5.51335300761468
"virginité",5,0.000425061633936921,12,0.000117006961914234,102558,7,7.70967564293188e-05,90795,5.51335300761468
"chier",19,0.0016152342089603,46,0.000448526687337897,102558,27,0.00029737320337023,90795,5.43167370379816
"manoir",7,0.000595086287511689,17,0.000165759862711831,102558,10,0.000110138223470455,90795,5.40308594746238
"bouter",9,0.000765110941086458,22,0.000214512763509429,102558,13,0.000143179690511592,90795,5.34371137661115
"sëoir",9,0.000765110941086458,22,0.000214512763509429,102558,13,0.000143179690511592,90795,5.34371137661115
"seulement",9,0.000765110941086458,22,0.000214512763509429,102558,13,0.000143179690511592,90795,5.34371137661115
"verité",13,0.00110516024823599,32,0.000312018565104624,102558,19,0.000209262624593865,90795,5.28121182834669
"lignage",8,0.000680098614299073,20,0.00019501160319039,102558,12,0.000132165868164546,90795,5.14579614044036
"povoir",8,0.000680098614299073,20,0.00019501160319039,102558,12,0.000132165868164546,90795,5.14579614044036
"decevoir",6,0.000510073960724305,15,0.000146258702392792,102558,9,9.91244011234099e-05,90795,5.14579614044036
"salir",6,0.000510073960724305,15,0.000146258702392792,102558,9,9.91244011234099e-05,90795,5.14579614044036
"lier",4,0.000340049307149537,10,9.75058015951949e-05,102558,6,6.60829340822732e-05,90795,5.14579614044036
"maladie",4,0.000340049307149537,10,9.75058015951949e-05,102558,6,6.60829340822732e-05,90795,5.14579614044036
"nouveau",4,0.000340049307149537,10,9.75058015951949e-05,102558,6,6.60829340822732e-05,90795,5.14579614044036
"piteux",4,0.000340049307149537,10,9.75058015951949e-05,102558,6,6.60829340822732e-05,90795,5.14579614044036
"trouver",69,0.00586585054832951,173,0.00168685036759687,102558,104,0.00114543752409274,90795,5.12105673591901
"pleurer",25,0.0021253081696846,63,0.000614286550049728,102558,38,0.000418525249187731,90795,5.0780882964872
"fuir",13,0.00110516024823599,33,0.000321769145264143,102558,20,0.000220276446940911,90795,5.01715123692936
"certain",16,0.00136019722859815,41,0.000399773786540299,102558,25,0.000275345558676139,90795,4.93996429482275
"retourner",23,0.00195528351610984,59,0.00057528422941165,102558,36,0.000396497604493639,90795,4.93138796792202
"clarté",7,0.000595086287511689,18,0.000175510442871351,102558,11,0.000121152045817501,90795,4.91189631587489
"rompre",7,0.000595086287511689,18,0.000175510442871351,102558,11,0.000121152045817501,90795,4.91189631587489
"endurer",12,0.00102014792144861,31,0.000302267984945104,102558,19,0.000209262624593865,90795,4.87496476462771
"apporter",5,0.000425061633936921,13,0.000126757542073753,102558,8,8.81105787763643e-05,90795,4.82418388166284
"loyal",5,0.000425061633936921,13,0.000126757542073753,102558,8,8.81105787763643e-05,90795,4.82418388166284
"ouvrer",5,0.000425061633936921,13,0.000126757542073753,102558,8,8.81105787763643e-05,90795,4.82418388166284
"prison",5,0.000425061633936921,13,0.000126757542073753,102558,8,8.81105787763643e-05,90795,4.82418388166284
"vendre",5,0.000425061633936921,13,0.000126757542073753,102558,8,8.81105787763643e-05,90795,4.82418388166284
"entrer",31,0.00263538213040891,81,0.000789796992921079,102558,50,0.000550691117352277,90795,4.78559041060954
"apercevoir",8,0.000680098614299073,21,0.000204762183349909,102558,13,0.000143179690511592,90795,4.7499656680988
"pays",8,0.000680098614299073,21,0.000204762183349909,102558,13,0.000143179690511592,90795,4.7499656680988
"argent",12,0.00102014792144861,32,0.000312018565104624,102558,20,0.000220276446940911,90795,4.63121652639633
"hautement",9,0.000765110941086458,24,0.000234013923828468,102558,15,0.000165207335205683,90795,4.63121652639633
"escrïer",6,0.000510073960724305,16,0.000156009282552312,102558,10,0.000110138223470455,90795,4.63121652639633
"pener",6,0.000510073960724305,16,0.000156009282552312,102558,10,0.000110138223470455,90795,4.63121652639633
"jeter",23,0.00195528351610984,62,0.000604535969890208,102558,39,0.000429539071534776,90795,4.55205043192801
"mestier",7,0.000595086287511689,19,0.00018526102303087,102558,12,0.000132165868164546,90795,4.50257162288532
"vieux",7,0.000595086287511689,19,0.00018526102303087,102558,12,0.000132165868164546,90795,4.50257162288532
"commander",22,0.00187027118932245,60,0.000585034809571169,102558,38,0.000418525249187731,90795,4.46871770090874
"päis",15,0.00127518490181076,41,0.000399773786540299,102558,26,0.000286359381023184,90795,4.45309281384262
"rendre",28,0.00238034515004676,77,0.000750794672283001,102558,49,0.000539677295005232,90795,4.41068240609174
"pitié",20,0.00170024653574768,55,0.000536281908773572,102558,35,0.000385483782146594,90795,4.41068240609174
"longuement",12,0.00102014792144861,33,0.000321769145264143,102558,21,0.000231290269287956,90795,4.41068240609174
"encontrer",4,0.000340049307149537,11,0.000107256381754714,102558,7,7.70967564293188e-05,90795,4.41068240609174
"laissier",4,0.000340049307149537,11,0.000107256381754714,102558,7,7.70967564293188e-05,90795,4.41068240609174
"loyer",4,0.000340049307149537,11,0.000107256381754714,102558,7,7.70967564293188e-05,90795,4.41068240609174
"veintre",4,0.000340049307149537,11,0.000107256381754714,102558,7,7.70967564293188e-05,90795,4.41068240609174
"venger",4,0.000340049307149537,11,0.000107256381754714,102558,7,7.70967564293188e-05,90795,4.41068240609174
"vision",4,0.000340049307149537,11,0.000107256381754714,102558,7,7.70967564293188e-05,90795,4.41068240609174
"briément",5,0.000425061633936921,14,0.000136508122233273,102558,9,9.91244011234099e-05,90795,4.28816345036697
"nouvelle",5,0.000425061633936921,14,0.000136508122233273,102558,9,9.91244011234099e-05,90795,4.28816345036697
"engendrer",6,0.000510073960724305,17,0.000165759862711831,102558,11,0.000121152045817501,90795,4.21019684217848
"fontaine",6,0.000510073960724305,17,0.000165759862711831,102558,11,0.000121152045817501,90795,4.21019684217848
"löer",6,0.000510073960724305,17,0.000165759862711831,102558,11,0.000121152045817501,90795,4.21019684217848
"partir",25,0.0021253081696846,71,0.000692291191325884,102558,46,0.000506635827964095,90795,4.19494250579378
"dormir",14,0.00119017257502338,40,0.00039002320638078,102558,26,0.000286359381023184,90795,4.15621995958645
"metre",51,0.00433562866615659,146,0.00142358470328985,102558,95,0.00104631312296933,90795,4.14372004993356
"perdre",24,0.00204029584289722,69,0.000672790031006845,102558,45,0.000495622005617049,90795,4.11663691235229
"apeler",16,0.00136019722859815,46,0.000448526687337897,102558,30,0.000330414670411366,90795,4.11663691235229
"mander",17,0.00144520955538553,49,0.000477778427816455,102558,32,0.000352442315105457,90795,4.10055629941342
"prière",9,0.000765110941086458,26,0.000253515084147507,102558,17,0.000187234979899774,90795,4.08636752329088
"esposer",11,0.000935135594661226,32,0.000312018565104624,102558,21,0.000231290269287956,90795,4.04312553891743
"issir",23,0.00195528351610984,67,0.000653288870687806,102558,44,0.000484608183270004,90795,4.03477197375438
"paradis",21,0.00178525886253507,62,0.000604535969890208,102558,41,0.000451566716228867,90795,3.95347752253345
"ardre",15,0.00127518490181076,45,0.000438776107178377,102558,30,0.000330414670411366,90795,3.85934710533027
"vertu",11,0.000935135594661226,33,0.000321769145264143,102558,22,0.000242304091635002,90795,3.85934710533027
"vif",10,0.000850123267873842,30,0.000292517404785585,102558,20,0.000220276446940911,90795,3.85934710533027
"batre",7,0.000595086287511689,21,0.000204762183349909,102558,14,0.000154193512858638,90795,3.85934710533027
"conforter",7,0.000595086287511689,21,0.000204762183349909,102558,14,0.000154193512858638,90795,3.85934710533027
"courroucer",7,0.000595086287511689,21,0.000204762183349909,102558,14,0.000154193512858638,90795,3.85934710533027
"reclamer",6,0.000510073960724305,18,0.000175510442871351,102558,12,0.000132165868164546,90795,3.85934710533027
"requerre",6,0.000510073960724305,18,0.000175510442871351,102558,12,0.000132165868164546,90795,3.85934710533027
"chasser",4,0.000340049307149537,12,0.000117006961914234,102558,8,8.81105787763643e-05,90795,3.85934710533027
"ermitage",4,0.000340049307149537,12,0.000117006961914234,102558,8,8.81105787763643e-05,90795,3.85934710533027
"ost",4,0.000340049307149537,12,0.000117006961914234,102558,8,8.81105787763643e-05,90795,3.85934710533027
"sacrer",4,0.000340049307149537,12,0.000117006961914234,102558,8,8.81105787763643e-05,90795,3.85934710533027
"plein",21,0.00178525886253507,64,0.000624037130209247,102558,43,0.000473594360922958,90795,3.76959484706678
"mer",14,0.00119017257502338,43,0.000419274946859338,102558,29,0.000319400848064321,90795,3.72626617066371
"crïer",12,0.00102014792144861,37,0.000360771465902221,102558,25,0.000275345558676139,90795,3.70497322111706
"fïer",12,0.00102014792144861,37,0.000360771465902221,102558,25,0.000275345558676139,90795,3.70497322111706
"öir",23,0.00195528351610984,71,0.000692291191325884,102558,48,0.000528663472658186,90795,3.69854097594151
"gésir",10,0.000850123267873842,31,0.000302267984945104,102558,21,0.000231290269287956,90795,3.67556867174312
"baron",9,0.000765110941086458,28,0.000273016244466546,102558,19,0.000209262624593865,90795,3.65622357347078
"espee",9,0.000765110941086458,28,0.000273016244466546,102558,19,0.000209262624593865,90795,3.65622357347078
"tolir",9,0.000765110941086458,28,0.000273016244466546,102558,19,0.000209262624593865,90795,3.65622357347078
"lire",8,0.000680098614299073,25,0.000243764503987987,102558,17,0.000187234979899774,90795,3.63232668736967
"requérir",14,0.00119017257502338,44,0.000429025527018858,102558,30,0.000330414670411366,90795,3.60205729830826
"recorder",7,0.000595086287511689,22,0.000214512763509429,102558,15,0.000165207335205683,90795,3.60205729830826
"tort",13,0.00110516024823599,41,0.000399773786540299,102558,28,0.000308387025717275,90795,3.58367945494954
"entendre",50,0.00425061633936921,158,0.00154059166520408,102558,108,0.00118949281348092,90795,3.57346954197247
"convertir",6,0.000510073960724305,19,0.00018526102303087,102558,13,0.000143179690511592,90795,3.5624742510741
"guise",6,0.000510073960724305,19,0.00018526102303087,102558,13,0.000143179690511592,90795,3.5624742510741
"demorer",5,0.000425061633936921,16,0.000156009282552312,102558,11,0.000121152045817501,90795,3.50849736848207
"occire",5,0.000425061633936921,16,0.000156009282552312,102558,11,0.000121152045817501,90795,3.50849736848207
"devenir",9,0.000765110941086458,29,0.000282766824626065,102558,20,0.000220276446940911,90795,3.47341239479725
"faillir",4,0.000340049307149537,13,0.000126757542073753,102558,9,9.91244011234099e-05,90795,3.43053076029358
"image",4,0.000340049307149537,13,0.000126757542073753,102558,9,9.91244011234099e-05,90795,3.43053076029358
"morir",12,0.00102014792144861,39,0.00038027262622126,102558,27,0.00029737320337023,90795,3.43053076029358
"avant",15,0.00127518490181076,49,0.000477778427816455,102558,34,0.000374469959799548,90795,3.40530626940906
"faim",7,0.000595086287511689,23,0.000224263343668948,102558,16,0.000176221157552729,90795,3.37692871716399
"chemin",6,0.000510073960724305,20,0.00019501160319039,102558,14,0.000154193512858638,90795,3.30801180456881
"ferir",6,0.000510073960724305,20,0.00019501160319039,102558,14,0.000154193512858638,90795,3.30801180456881
"tour",6,0.000510073960724305,20,0.00019501160319039,102558,14,0.000154193512858638,90795,3.30801180456881
"aval",3,0.000255036980362153,10,9.75058015951949e-05,102558,7,7.70967564293188e-05,90795,3.30801180456881
"embler",3,0.000255036980362153,10,9.75058015951949e-05,102558,7,7.70967564293188e-05,90795,3.30801180456881
"méfait",3,0.000255036980362153,10,9.75058015951949e-05,102558,7,7.70967564293188e-05,90795,3.30801180456881
"palais",3,0.000255036980362153,10,9.75058015951949e-05,102558,7,7.70967564293188e-05,90795,3.30801180456881
"piéça",3,0.000255036980362153,10,9.75058015951949e-05,102558,7,7.70967564293188e-05,90795,3.30801180456881
"refuser",3,0.000255036980362153,10,9.75058015951949e-05,102558,7,7.70967564293188e-05,90795,3.30801180456881
"trembler",3,0.000255036980362153,10,9.75058015951949e-05,102558,7,7.70967564293188e-05,90795,3.30801180456881
"moutier",11,0.000935135594661226,37,0.000360771465902221,102558,26,0.000286359381023184,90795,3.26560139681792
"nu",8,0.000680098614299073,27,0.000263265664307026,102558,19,0.000209262624593865,90795,3.24997650975181
"recevoir",13,0.00110516024823599,44,0.000429025527018858,102558,31,0.000341428492758412,90795,3.23687176576087
"boire",5,0.000425061633936921,17,0.000165759862711831,102558,12,0.000132165868164546,90795,3.21612258777523
"querre",17,0.00144520955538553,58,0.00056553364925213,102558,41,0.000451566716228867,90795,3.20043418490803
"tirer",9,0.000765110941086458,31,0.000302267984945104,102558,22,0.000242304091635002,90795,3.15764763163386
"tenir",41,0.00348550539828275,142,0.00138458238265177,102558,101,0.0011123960570516,90795,3.13333131323844
"laisser",28,0.00238034515004676,98,0.00095555685563291,102558,70,0.000770967564293188,90795,3.08747768426422
"vivre",16,0.00136019722859815,56,0.000546032488933092,102558,40,0.000440552893881822,90795,3.08747768426422
"retenir",8,0.000680098614299073,28,0.000273016244466546,102558,20,0.000220276446940911,90795,3.08747768426422
"jurer",6,0.000510073960724305,21,0.000204762183349909,102558,15,0.000165207335205683,90795,3.08747768426422
"biere",4,0.000340049307149537,14,0.000136508122233273,102558,10,0.000110138223470455,90795,3.08747768426422
"tüer",4,0.000340049307149537,14,0.000136508122233273,102558,10,0.000110138223470455,90795,3.08747768426422
"armer",9,0.000765110941086458,32,0.000312018565104624,102558,23,0.000253317913982047,90795,3.02035860417152
"matin",9,0.000765110941086458,32,0.000312018565104624,102558,23,0.000253317913982047,90795,3.02035860417152
"conquerre",5,0.000425061633936921,18,0.000175510442871351,102558,13,0.000143179690511592,90795,2.96872854256175
"emporter",5,0.000425061633936921,18,0.000175510442871351,102558,13,0.000143179690511592,90795,2.96872854256175
"pechëor",5,0.000425061633936921,18,0.000175510442871351,102558,13,0.000143179690511592,90795,2.96872854256175
"donner",40,0.00340049307149537,145,0.00141383412313033,102558,105,0.00115645134643978,90795,2.94045493739449
"sentir",9,0.000765110941086458,33,0.000321769145264143,102558,24,0.000264331736329093,90795,2.8945103289977
"aider",3,0.000255036980362153,11,0.000107256381754714,102558,8,8.81105787763643e-05,90795,2.8945103289977
"chevauchier",3,0.000255036980362153,11,0.000107256381754714,102558,8,8.81105787763643e-05,90795,2.8945103289977
"chief",3,0.000255036980362153,11,0.000107256381754714,102558,8,8.81105787763643e-05,90795,2.8945103289977
"détruire",3,0.000255036980362153,11,0.000107256381754714,102558,8,8.81105787763643e-05,90795,2.8945103289977
"lusure",3,0.000255036980362153,11,0.000107256381754714,102558,8,8.81105787763643e-05,90795,2.8945103289977
"moitié",3,0.000255036980362153,11,0.000107256381754714,102558,8,8.81105787763643e-05,90795,2.8945103289977
"pis",3,0.000255036980362153,11,0.000107256381754714,102558,8,8.81105787763643e-05,90795,2.8945103289977
"poisson",3,0.000255036980362153,11,0.000107256381754714,102558,8,8.81105787763643e-05,90795,2.8945103289977
"fin",17,0.00144520955538553,63,0.000614286550049728,102558,46,0.000506635827964095,90795,2.85256090393977
"dur",7,0.000595086287511689,26,0.000253515084147507,102558,19,0.000209262624593865,90795,2.84372944603283
"hardi",7,0.000595086287511689,26,0.000253515084147507,102558,19,0.000209262624593865,90795,2.84372944603283
"combattre",4,0.000340049307149537,15,0.000146258702392792,102558,11,0.000121152045817501,90795,2.80679789478565
"mois",4,0.000340049307149537,15,0.000146258702392792,102558,11,0.000121152045817501,90795,2.80679789478565
"rire",4,0.000340049307149537,15,0.000146258702392792,102558,11,0.000121152045817501,90795,2.80679789478565
"Sans",4,0.000340049307149537,15,0.000146258702392792,102558,11,0.000121152045817501,90795,2.80679789478565
"pucelle",9,0.000765110941086458,34,0.000331519725423663,102558,25,0.000275345558676139,90795,2.7787299158378
"revenir",10,0.000850123267873842,38,0.000370522046061741,102558,28,0.000308387025717275,90795,2.75667650380734
"repentir",5,0.000425061633936921,19,0.00018526102303087,102558,14,0.000154193512858638,90795,2.75667650380734
"souvenir",5,0.000425061633936921,19,0.00018526102303087,102558,14,0.000154193512858638,90795,2.75667650380734
"häir",6,0.000510073960724305,23,0.000224263343668948,102558,17,0.000187234979899774,90795,2.72424501552725
"ariere",7,0.000595086287511689,27,0.000263265664307026,102558,20,0.000220276446940911,90795,2.70154297373119
"douter",11,0.000935135594661226,43,0.000419274946859338,102558,32,0.000352442315105457,90795,2.65330113491456
"penser",14,0.00119017257502338,55,0.000536281908773572,102558,41,0.000451566716228867,90795,2.63565168168897
"jesir",10,0.000850123267873842,40,0.00039002320638078,102558,30,0.000330414670411366,90795,2.57289807022018
"quérir",10,0.000850123267873842,40,0.00039002320638078,102558,30,0.000330414670411366,90795,2.57289807022018
"vin",5,0.000425061633936921,20,0.00019501160319039,102558,15,0.000165207335205683,90795,2.57289807022018
"couvrir",4,0.000340049307149537,16,0.000156009282552312,102558,12,0.000132165868164546,90795,2.57289807022018
"chevaucher",3,0.000255036980362153,12,0.000117006961914234,102558,9,9.91244011234099e-05,90795,2.57289807022018
"aller",59,0.00501572728045567,236,0.0023011369176466,102558,177,0.00194944655542706,90795,2.57289807022018
"priier",18,0.00153022188217292,74,0.000721542931804442,102558,56,0.00061677405143455,90795,2.4810088534266
"petit",15,0.00127518490181076,62,0.000604535969890208,102558,47,0.00051764965031114,90795,2.46341304595549
"aler",64,0.00544078891439259,265,0.00258390374227267,102558,201,0.00221377829175615,90795,2.45769367901629
"falir",13,0.00110516024823599,54,0.000526531328614053,102558,41,0.000451566716228867,90795,2.44739084728261
"tendrement",6,0.000510073960724305,25,0.000243764503987987,102558,19,0.000209262624593865,90795,2.43748238231386
"prier",14,0.00119017257502338,59,0.00057528422941165,102558,45,0.000495622005617049,90795,2.4013715322055
"gent",36,0.00306044376434583,153,0.00149183876440648,102558,117,0.00128861721460433,90795,2.3749828340494
"penitence",4,0.000340049307149537,17,0.000165759862711831,102558,13,0.000143179690511592,90795,2.3749828340494
"veillier",4,0.000340049307149537,17,0.000165759862711831,102558,13,0.000143179690511592,90795,2.3749828340494
"garder",29,0.00246535747683414,124,0.00120907193978042,102558,95,0.00104631312296933,90795,2.35623296957006
"trover",7,0.000595086287511689,30,0.000292517404785585,102558,23,0.000253317913982047,90795,2.34916780324451
"souvent",16,0.00136019722859815,69,0.000672790031006845,102558,53,0.000583732584393414,90795,2.33017183718054
"créance",3,0.000255036980362153,13,0.000126757542073753,102558,10,0.000110138223470455,90795,2.31560826319816
"environ",3,0.000255036980362153,13,0.000126757542073753,102558,10,0.000110138223470455,90795,2.31560826319816
"laver",3,0.000255036980362153,13,0.000126757542073753,102558,10,0.000110138223470455,90795,2.31560826319816
"oster",3,0.000255036980362153,13,0.000126757542073753,102558,10,0.000110138223470455,90795,2.31560826319816
"despit",8,0.000680098614299073,35,0.000341270305583182,102558,27,0.00029737320337023,90795,2.28702050686238
"cité",14,0.00119017257502338,62,0.000604535969890208,102558,48,0.000528663472658186,90795,2.25128581144266
"servir",26,0.00221032049647199,116,0.00113106729850426,102558,90,0.000991244011234099,90795,2.22984499419082
"non",14,0.00119017257502338,63,0.000614286550049728,102558,49,0.000539677295005232,90795,2.20534120304587
"sens",8,0.000680098614299073,36,0.000351020885742702,102558,28,0.000308387025717275,90795,2.20534120304587
"choir",6,0.000510073960724305,27,0.000263265664307026,102558,21,0.000231290269287956,90795,2.20534120304587
"otroiier",4,0.000340049307149537,18,0.000175510442871351,102558,14,0.000154193512858638,90795,2.20534120304587
"peine",16,0.00136019722859815,73,0.000711792351644923,102558,57,0.000627787873781596,90795,2.16665100650121
"traire",10,0.000850123267873842,46,0.000448526687337897,102558,36,0.000396497604493639,90795,2.14408172518349
"mourir",23,0.00195528351610984,106,0.00103356149690907,102558,83,0.00091414725480478,90795,2.13891526319509
"oraison",12,0.00102014792144861,56,0.000546032488933092,102558,44,0.000484608183270004,90795,2.10509842108924
"ire",3,0.000255036980362153,14,0.000136508122233273,102558,11,0.000121152045817501,90795,2.10509842108924
"message",3,0.000255036980362153,14,0.000136508122233273,102558,11,0.000121152045817501,90795,2.10509842108924
"user",3,0.000255036980362153,14,0.000136508122233273,102558,11,0.000121152045817501,90795,2.10509842108924
"assez",13,0.00110516024823599,61,0.000594785389730689,102558,48,0.000528663472658186,90795,2.0904796820539
"envoyer",7,0.000595086287511689,33,0.000321769145264143,102558,26,0.000286359381023184,90795,2.07810997979322
"valoir",11,0.000935135594661226,52,0.000507030168295014,102558,41,0.000451566716228867,90795,2.0708691784699
"lit",9,0.000765110941086458,43,0.000419274946859338,102558,34,0.000374469959799548,90795,2.04318376164544
"ici",5,0.000425061633936921,24,0.000234013923828468,102558,19,0.000209262624593865,90795,2.03123531859488
"os",5,0.000425061633936921,24,0.000234013923828468,102558,19,0.000209262624593865,90795,2.03123531859488
"voir",46,0.00391056703221967,222,0.00216462879541333,102558,176,0.00193843273308002,90795,2.01738598687719
"nom",17,0.00144520955538553,84,0.000819048733399637,102558,67,0.000737926097252051,90795,1.95847465046611
"connaître",9,0.000765110941086458,45,0.000438776107178377,102558,36,0.000396497604493639,90795,1.92967355266514
"courtois",5,0.000425061633936921,25,0.000243764503987987,102558,20,0.000220276446940911,90795,1.92967355266514
"respondre",5,0.000425061633936921,25,0.000243764503987987,102558,20,0.000220276446940911,90795,1.92967355266514
"noir",4,0.000340049307149537,20,0.00019501160319039,102558,16,0.000176221157552729,90795,1.92967355266514
"demain",3,0.000255036980362153,15,0.000146258702392792,102558,12,0.000132165868164546,90795,1.92967355266514
"dent",3,0.000255036980362153,15,0.000146258702392792,102558,12,0.000132165868164546,90795,1.92967355266514
"fête",2,0.000170024653574768,10,9.75058015951949e-05,102558,8,8.81105787763643e-05,90795,1.92967355266514
"garir",2,0.000170024653574768,10,9.75058015951949e-05,102558,8,8.81105787763643e-05,90795,1.92967355266514
"joyeux",2,0.000170024653574768,10,9.75058015951949e-05,102558,8,8.81105787763643e-05,90795,1.92967355266514
"méfaire",2,0.000170024653574768,10,9.75058015951949e-05,102558,8,8.81105787763643e-05,90795,1.92967355266514
"solas",2,0.000170024653574768,10,9.75058015951949e-05,102558,8,8.81105787763643e-05,90795,1.92967355266514
"ouïr",42,0.00357051772507014,215,0.00209637473429669,102558,173,0.00190539126603888,90795,1.8739026407384
"fait",6,0.000510073960724305,31,0.000302267984945104,102558,25,0.000275345558676139,90795,1.85248661055853
"doner",9,0.000765110941086458,47,0.000458277267497416,102558,38,0.000418525249187731,90795,1.82811178673539
"mettre",22,0.00187027118932245,116,0.00113106729850426,102558,94,0.00103529930062228,90795,1.80650290036736
"honneur",7,0.000595086287511689,37,0.000360771465902221,102558,30,0.000330414670411366,90795,1.80102864915413
"main",18,0.00153022188217292,96,0.000936055695313871,102558,78,0.000859078143069552,90795,1.78123712553705
"garde",3,0.000255036980362153,16,0.000156009282552312,102558,13,0.000143179690511592,90795,1.78123712553705
"part",11,0.000935135594661226,59,0.00057528422941165,102558,48,0.000528663472658186,90795,1.76886742327638
"fois",9,0.000765110941086458,49,0.000477778427816455,102558,40,0.000440552893881822,90795,1.73670619739862
"mieux",8,0.000680098614299073,44,0.000429025527018858,102558,36,0.000396497604493639,90795,1.71526538014679
"merveille",4,0.000340049307149537,22,0.000214512763509429,102558,18,0.00019824880224682,90795,1.71526538014679
"abbaye",2,0.000170024653574768,11,0.000107256381754714,102558,9,9.91244011234099e-05,90795,1.71526538014679
"cheminer",2,0.000170024653574768,11,0.000107256381754714,102558,9,9.91244011234099e-05,90795,1.71526538014679
"créature",2,0.000170024653574768,11,0.000107256381754714,102558,9,9.91244011234099e-05,90795,1.71526538014679
"doute",2,0.000170024653574768,11,0.000107256381754714,102558,9,9.91244011234099e-05,90795,1.71526538014679
"lendemain",2,0.000170024653574768,11,0.000107256381754714,102558,9,9.91244011234099e-05,90795,1.71526538014679
"marchëant",2,0.000170024653574768,11,0.000107256381754714,102558,9,9.91244011234099e-05,90795,1.71526538014679
"Mercure",2,0.000170024653574768,11,0.000107256381754714,102558,9,9.91244011234099e-05,90795,1.71526538014679
"miséricorde",2,0.000170024653574768,11,0.000107256381754714,102558,9,9.91244011234099e-05,90795,1.71526538014679
"pomme",2,0.000170024653574768,11,0.000107256381754714,102558,9,9.91244011234099e-05,90795,1.71526538014679
"bas",5,0.000425061633936921,28,0.000273016244466546,102558,23,0.000253317913982047,90795,1.67797700231751
"chëoir",5,0.000425061633936921,28,0.000273016244466546,102558,23,0.000253317913982047,90795,1.67797700231751
"manger",5,0.000425061633936921,28,0.000273016244466546,102558,23,0.000253317913982047,90795,1.67797700231751
"vëoir",56,0.00476069030009351,315,0.00307143275024864,102558,259,0.0028525799878848,90795,1.66890685635904
"enfant",37,0.00314545609113321,209,0.00203787125333957,102558,172,0.00189437744369183,90795,1.66041677787465
"mos",3,0.000255036980362153,17,0.000165759862711831,102558,14,0.000154193512858638,90795,1.6540059022844
"joie",20,0.00170024653574768,115,0.00112131671834474,102558,95,0.00104631312296933,90795,1.6249882548759
"chevalier",16,0.00136019722859815,92,0.000897053374675793,102558,76,0.000837050498375461,90795,1.6249882548759
"autel",4,0.000340049307149537,23,0.000224263343668948,102558,19,0.000209262624593865,90795,1.6249882548759
"fief",4,0.000340049307149537,23,0.000224263343668948,102558,19,0.000209262624593865,90795,1.6249882548759
"péché",9,0.000765110941086458,52,0.000507030168295014,102558,43,0.000473594360922958,90795,1.6155406487429
"ennemi",23,0.00195528351610984,133,0.00129682716121609,102558,110,0.00121152045817501,90795,1.61390878950175
"bel",17,0.00144520955538553,99,0.00096530743579243,102558,82,0.000903133432457734,90795,1.60021709245402
"pro",7,0.000595086287511689,41,0.000399773786540299,102558,34,0.000374469959799548,90795,1.58914292572423
"ci",16,0.00136019722859815,94,0.000916554534994832,102558,78,0.000859078143069552,90795,1.58332188936627
"souffrir",16,0.00136019722859815,94,0.000916554534994832,102558,78,0.000859078143069552,90795,1.58332188936627
"foi",11,0.000935135594661226,65,0.000633787710368767,102558,54,0.000594746406740459,90795,1.57232659846789
"doucement",12,0.00102014792144861,71,0.000692291191325884,102558,59,0.000649815518475687,90795,1.56990390725299
"prendre",44,0.0037405423786449,262,0.00255465200179411,102558,218,0.00240101327165593,90795,1.55790158380305
"felon",4,0.000340049307149537,24,0.000234013923828468,102558,20,0.000220276446940911,90795,1.54373884213211
"oser",4,0.000340049307149537,24,0.000234013923828468,102558,20,0.000220276446940911,90795,1.54373884213211
"marchéant",3,0.000255036980362153,18,0.000175510442871351,102558,15,0.000165207335205683,90795,1.54373884213211
"estovoir",2,0.000170024653574768,12,0.000117006961914234,102558,10,0.000110138223470455,90795,1.54373884213211
"glouton",2,0.000170024653574768,12,0.000117006961914234,102558,10,0.000110138223470455,90795,1.54373884213211
"hôtel",2,0.000170024653574768,12,0.000117006961914234,102558,10,0.000110138223470455,90795,1.54373884213211
"Mahom",2,0.000170024653574768,12,0.000117006961914234,102558,10,0.000110138223470455,90795,1.54373884213211
"poindre",2,0.000170024653574768,12,0.000117006961914234,102558,10,0.000110138223470455,90795,1.54373884213211
"vent",2,0.000170024653574768,12,0.000117006961914234,102558,10,0.000110138223470455,90795,1.54373884213211
"pain",7,0.000595086287511689,43,0.000419274946859338,102558,36,0.000396497604493639,90795,1.50085720762844
"gré",6,0.000510073960724305,37,0.000360771465902221,102558,31,0.000341428492758412,90795,1.49394081496656
"montrer",6,0.000510073960724305,37,0.000360771465902221,102558,31,0.000341428492758412,90795,1.49394081496656
"voloir",19,0.0016152342089603,119,0.00116031903898282,102558,100,0.00110138223470455,90795,1.4665519000255
"répondre",13,0.00110516024823599,82,0.000799547573080598,102558,69,0.000759953741946142,90795,1.45424673534184
"esprit",3,0.000255036980362153,19,0.00018526102303087,102558,16,0.000176221157552729,90795,1.44725516449885
"soir",3,0.000255036980362153,19,0.00018526102303087,102558,16,0.000176221157552729,90795,1.44725516449885
"là",18,0.00153022188217292,115,0.00112131671834474,102558,97,0.00106834076766342,90795,1.43233500816381
"Alexis",9,0.000765110941086458,58,0.00056553364925213,102558,49,0.000539677295005232,90795,1.4177193448152
"entour",4,0.000340049307149537,26,0.000253515084147507,102558,22,0.000242304091635002,90795,1.40339894739283
"compagnon",2,0.000170024653574768,13,0.000126757542073753,102558,11,0.000121152045817501,90795,1.40339894739283
"lai",2,0.000170024653574768,13,0.000126757542073753,102558,11,0.000121152045817501,90795,1.40339894739283
"convenir",6,0.000510073960724305,39,0.00038027262622126,102558,33,0.000363456137452503,90795,1.40339894739283
"savoir",57,0.0048457026268809,374,0.00364671697966029,102558,317,0.00349138168401344,90795,1.38790400633328
"cuidier",11,0.000935135594661226,73,0.000711792351644923,102558,62,0.000682856985516824,90795,1.36944574705268
"maistre",3,0.000255036980362153,20,0.00019501160319039,102558,17,0.000187234979899774,90795,1.36212250776363
"plaire",10,0.000850123267873842,68,0.000663039450847325,102558,58,0.000638801696128641,90795,1.33080934666561
"pié",5,0.000425061633936921,34,0.000331519725423663,102558,29,0.000319400848064321,90795,1.33080934666561
"chien",9,0.000765110941086458,62,0.000604535969890208,102558,53,0.000583732584393414,90795,1.31072165841405
"glorieux",5,0.000425061633936921,35,0.000341270305583182,102558,30,0.000330414670411366,90795,1.28644903511009
"maintenant",4,0.000340049307149537,28,0.000273016244466546,102558,24,0.000264331736329093,90795,1.28644903511009
"Sarrasin",4,0.000340049307149537,28,0.000273016244466546,102558,24,0.000264331736329093,90795,1.28644903511009
"degré",3,0.000255036980362153,21,0.000204762183349909,102558,18,0.00019824880224682,90795,1.28644903511009
"boivre",2,0.000170024653574768,14,0.000136508122233273,102558,12,0.000132165868164546,90795,1.28644903511009
"essil",2,0.000170024653574768,14,0.000136508122233273,102558,12,0.000132165868164546,90795,1.28644903511009
"oeil",2,0.000170024653574768,14,0.000136508122233273,102558,12,0.000132165868164546,90795,1.28644903511009
"bois",6,0.000510073960724305,43,0.000419274946859338,102558,37,0.000407511426840685,90795,1.25168014226928
"amour",11,0.000935135594661226,79,0.00077029583260204,102558,68,0.000748939919599097,90795,1.24861229878332
"chrétien",5,0.000425061633936921,36,0.000351020885742702,102558,31,0.000341428492758412,90795,1.2449506791388
"las",4,0.000340049307149537,29,0.000282766824626065,102558,25,0.000275345558676139,90795,1.23499107370569
"fors",10,0.000850123267873842,73,0.000711792351644923,102558,63,0.000693870807863869,90795,1.22518955724771
"cheval",6,0.000510073960724305,44,0.000429025527018858,102558,38,0.000418525249187731,90795,1.21874119115693
"gloire",3,0.000255036980362153,22,0.000214512763509429,102558,19,0.000209262624593865,90795,1.21874119115693
"amor",5,0.000425061633936921,37,0.000360771465902221,102558,32,0.000352442315105457,90795,1.20604597041571
"courir",5,0.000425061633936921,37,0.000360771465902221,102558,32,0.000352442315105457,90795,1.20604597041571
"ainsi",16,0.00136019722859815,120,0.00117006961914234,102558,104,0.00114543752409274,90795,1.1874914170247
"pechié",4,0.000340049307149537,30,0.000292517404785585,102558,26,0.000286359381023184,90795,1.1874914170247
"fou",2,0.000170024653574768,15,0.000146258702392792,102558,13,0.000143179690511592,90795,1.1874914170247
"plaie",2,0.000170024653574768,15,0.000146258702392792,102558,13,0.000143179690511592,90795,1.1874914170247
"devoir",23,0.00195528351610984,174,0.00169660094775639,102558,151,0.00166308717440388,90795,1.17569514467015
"ja",14,0.00119017257502338,107,0.00104331207706859,102558,93,0.00102428547827524,90795,1.16195396719621
"honte",3,0.000255036980362153,23,0.000224263343668948,102558,20,0.000220276446940911,90795,1.15780413159908
"Jésus-Christ",11,0.000935135594661226,85,0.000828799313559157,102558,74,0.00081502285368137,90795,1.14737346374684
"rien",14,0.00119017257502338,109,0.00106281323738762,102558,95,0.00104631312296933,90795,1.13749177841313
"moi",16,0.00136019722859815,127,0.00123832368025898,102558,111,0.00122253428052206,90795,1.11260457090602
"paix",4,0.000340049307149537,32,0.000312018565104624,102558,28,0.000308387025717275,90795,1.10267060152294
"premier",4,0.000340049307149537,32,0.000312018565104624,102558,28,0.000308387025717275,90795,1.10267060152294
"anel",2,0.000170024653574768,16,0.000156009282552312,102558,14,0.000154193512858638,90795,1.10267060152294
"ça",2,0.000170024653574768,16,0.000156009282552312,102558,14,0.000154193512858638,90795,1.10267060152294
"cher",2,0.000170024653574768,16,0.000156009282552312,102558,14,0.000154193512858638,90795,1.10267060152294
"fruit",2,0.000170024653574768,16,0.000156009282552312,102558,14,0.000154193512858638,90795,1.10267060152294
"gros",2,0.000170024653574768,16,0.000156009282552312,102558,14,0.000154193512858638,90795,1.10267060152294
"poi",2,0.000170024653574768,16,0.000156009282552312,102558,14,0.000154193512858638,90795,1.10267060152294
"an",11,0.000935135594661226,91,0.000887302794516274,102558,80,0.000881105787763643,90795,1.06132045396582
"grand",9,0.000765110941086458,75,0.000731293511963962,102558,66,0.000726912274905006,90795,1.05254921054462
"pouvoir",25,0.0021253081696846,210,0.00204762183349909,102558,185,0.00203755713420343,90795,1.0430667852244
"fortement",14,0.00119017257502338,119,0.00116031903898282,102558,105,0.00115645134643978,90795,1.02915922808807
"fol",4,0.000340049307149537,34,0.000331519725423663,102558,30,0.000330414670411366,90795,1.02915922808807
"suivre",2,0.000170024653574768,17,0.000165759862711831,102558,15,0.000165207335205683,90795,1.02915922808807
"venir",54,0.00459066564651875,464,0.00452426919401704,102558,410,0.00451566716228867,90795,1.01660850579432
"croire",17,0.00144520955538553,148,0.00144308586360888,102558,131,0.00144281072746297,90795,1.0016626074903
"mort",9,0.000765110941086458,80,0.000780046412761559,102558,71,0.000781981386640233,90795,0.978426026703449
"lieu",10,0.000850123267873842,90,0.000877552214356754,102558,80,0.000881105787763643,90795,0.964836776332568
"quoi",6,0.000510073960724305,54,0.000526531328614053,102558,48,0.000528663472658186,90795,0.964836776332568
"œil",3,0.000255036980362153,27,0.000263265664307026,102558,24,0.000264331736329093,90795,0.964836776332568
"faux",2,0.000170024653574768,18,0.000175510442871351,102558,16,0.000176221157552729,90795,0.964836776332568
"lance",2,0.000170024653574768,18,0.000175510442871351,102558,16,0.000176221157552729,90795,0.964836776332568
"fort",11,0.000935135594661226,100,0.000975058015951949,102558,89,0.000980230188887053,90795,0.953995913677146
"mere",19,0.0016152342089603,174,0.00169660094775639,102558,155,0.00170714246379206,90795,0.946162516145486
"monde",11,0.000935135594661226,101,0.000984808596111469,102558,90,0.000991244011234099,90795,0.943395959080733
"comment",12,0.00102014792144861,111,0.00108231439770666,102558,99,0.00109036841235751,90795,0.935599298261884
"église",8,0.000680098614299073,74,0.000721542931804442,102558,66,0.000726912274905006,90795,0.935599298261884
"faire",134,0.0113916517895095,1260,0.0122857310009946,102558,1126,0.0124015639627733,90795,0.918565740877898
"seneschal",2,0.000170024653574768,19,0.00018526102303087,102558,17,0.000187234979899774,90795,0.908081671842417
"mauvais",6,0.000510073960724305,57,0.000555783069092611,102558,51,0.000561704939699323,90795,0.908081671842417
"frère",6,0.000510073960724305,58,0.00056553364925213,102558,52,0.000572718762046368,90795,0.890618562768524
"Jésus",14,0.00119017257502338,138,0.00134558006201369,102558,124,0.00136571397103365,90795,0.871465475397158
"ame",8,0.000680098614299073,79,0.00077029583260204,102558,71,0.000781981386640233,90795,0.8697120237364
"pucele",4,0.000340049307149537,40,0.00039002320638078,102558,36,0.000396497604493639,90795,0.857632690073394
"larron",2,0.000170024653574768,20,0.00019501160319039,102558,18,0.00019824880224682,90795,0.857632690073394
"croître",1,8.50123267873842e-05,10,9.75058015951949e-05,102558,9,9.91244011234099e-05,90795,0.857632690073394
"cruel",1,8.50123267873842e-05,10,9.75058015951949e-05,102558,9,9.91244011234099e-05,90795,0.857632690073394
"cuider",1,8.50123267873842e-05,10,9.75058015951949e-05,102558,9,9.91244011234099e-05,90795,0.857632690073394
"damoiseau",1,8.50123267873842e-05,10,9.75058015951949e-05,102558,9,9.91244011234099e-05,90795,0.857632690073394
"dessous",1,8.50123267873842e-05,10,9.75058015951949e-05,102558,9,9.91244011234099e-05,90795,0.857632690073394
"état",1,8.50123267873842e-05,10,9.75058015951949e-05,102558,9,9.91244011234099e-05,90795,0.857632690073394
"idole",1,8.50123267873842e-05,10,9.75058015951949e-05,102558,9,9.91244011234099e-05,90795,0.857632690073394
"Odon",1,8.50123267873842e-05,10,9.75058015951949e-05,102558,9,9.91244011234099e-05,90795,0.857632690073394
"quite",1,8.50123267873842e-05,10,9.75058015951949e-05,102558,9,9.91244011234099e-05,90795,0.857632690073394
"Rebebus",1,8.50123267873842e-05,10,9.75058015951949e-05,102558,9,9.91244011234099e-05,90795,0.857632690073394
"sofrir",1,8.50123267873842e-05,10,9.75058015951949e-05,102558,9,9.91244011234099e-05,90795,0.857632690073394
"jour",19,0.0016152342089603,191,0.00186236081046822,102558,172,0.00189437744369183,90795,0.8526464535032
"enfer",8,0.000680098614299073,82,0.000799547573080598,102558,74,0.00081502285368137,90795,0.834453428179518
"sergent",3,0.000255036980362153,31,0.000302267984945104,102558,28,0.000308387025717275,90795,0.827002951142201
"dire",110,0.00935135594661226,1167,0.0113789270461592,102558,1057,0.0116416102208271,90795,0.803269974619357
"pöoir",18,0.00153022188217292,191,0.00186236081046822,102558,173,0.00190539126603888,90795,0.803101131745028
"droit",11,0.000935135594661226,117,0.00114081787866378,102558,106,0.00116746516878683,90795,0.800996569030811
"terre",12,0.00102014792144861,128,0.00124807426041849,102558,116,0.00127760339225728,90795,0.798485607999367
"sien",4,0.000340049307149537,43,0.000419274946859338,102558,39,0.000429539071534776,90795,0.791660944683133
"vrai",4,0.000340049307149537,43,0.000419274946859338,102558,39,0.000429539071534776,90795,0.791660944683133
"commencer",5,0.000425061633936921,54,0.000526531328614053,102558,49,0.000539677295005232,90795,0.787621858230668
"croix",5,0.000425061633936921,55,0.000536281908773572,102558,50,0.000550691117352277,90795,0.771869421066055
"beste",1,8.50123267873842e-05,11,0.000107256381754714,102558,10,0.000110138223470455,90795,0.771869421066055
"escuier",1,8.50123267873842e-05,11,0.000107256381754714,102558,10,0.000110138223470455,90795,0.771869421066055
"Julien",1,8.50123267873842e-05,11,0.000107256381754714,102558,10,0.000110138223470455,90795,0.771869421066055
"père",19,0.0016152342089603,211,0.00205737241365861,102558,192,0.00211465389063274,90795,0.763829114596617
"reine",4,0.000340049307149537,45,0.000438776107178377,102558,41,0.000451566716228867,90795,0.753043337625419
"ciel",7,0.000595086287511689,79,0.00077029583260204,102558,72,0.000792995208987279,90795,0.75042860381422
"faus",2,0.000170024653574768,23,0.000224263343668948,102558,21,0.000231290269287956,90795,0.735113734348623
"genou",2,0.000170024653574768,23,0.000224263343668948,102558,21,0.000231290269287956,90795,0.735113734348623
"point",9,0.000765110941086458,104,0.00101406033659003,102558,95,0.00104631312296933,90795,0.731244714694157
"juif",2,0.000170024653574768,24,0.000234013923828468,102558,22,0.000242304091635002,90795,0.701699473696413
"païen",2,0.000170024653574768,24,0.000234013923828468,102558,22,0.000242304091635002,90795,0.701699473696413
"pied",2,0.000170024653574768,24,0.000234013923828468,102558,22,0.000242304091635002,90795,0.701699473696413
"Basilles",1,8.50123267873842e-05,12,0.000117006961914234,102558,11,0.000121152045817501,90795,0.701699473696413
"catre",1,8.50123267873842e-05,12,0.000117006961914234,102558,11,0.000121152045817501,90795,0.701699473696413
"chapelle",1,8.50123267873842e-05,12,0.000117006961914234,102558,11,0.000121152045817501,90795,0.701699473696413
"chetif",1,8.50123267873842e-05,12,0.000117006961914234,102558,11,0.000121152045817501,90795,0.701699473696413
"comander",1,8.50123267873842e-05,12,0.000117006961914234,102558,11,0.000121152045817501,90795,0.701699473696413
"cuisse",1,8.50123267873842e-05,12,0.000117006961914234,102558,11,0.000121152045817501,90795,0.701699473696413
"dit",1,8.50123267873842e-05,12,0.000117006961914234,102558,11,0.000121152045817501,90795,0.701699473696413
"face",1,8.50123267873842e-05,12,0.000117006961914234,102558,11,0.000121152045817501,90795,0.701699473696413
"jadis",1,8.50123267873842e-05,12,0.000117006961914234,102558,11,0.000121152045817501,90795,0.701699473696413
"justice",1,8.50123267873842e-05,12,0.000117006961914234,102558,11,0.000121152045817501,90795,0.701699473696413
"Martin",1,8.50123267873842e-05,12,0.000117006961914234,102558,11,0.000121152045817501,90795,0.701699473696413
"sain",4,0.000340049307149537,50,0.000487529007975975,102558,46,0.000506635827964095,90795,0.671190800927004
"parole",3,0.000255036980362153,38,0.000370522046061741,102558,35,0.000385483782146594,90795,0.661602360913761
"vouloir",30,0.00255036980362153,390,0.0038027262622126,102558,360,0.0039649760449364,90795,0.643224517555046
"loi",2,0.000170024653574768,26,0.000253515084147507,102558,24,0.000264331736329093,90795,0.643224517555046
"bataille",1,8.50123267873842e-05,13,0.000126757542073753,102558,12,0.000132165868164546,90795,0.643224517555046
"chatel",1,8.50123267873842e-05,13,0.000126757542073753,102558,12,0.000132165868164546,90795,0.643224517555046
"cote",1,8.50123267873842e-05,13,0.000126757542073753,102558,12,0.000132165868164546,90795,0.643224517555046
"orgueil",1,8.50123267873842e-05,13,0.000126757542073753,102558,12,0.000132165868164546,90795,0.643224517555046
"pan",1,8.50123267873842e-05,13,0.000126757542073753,102558,12,0.000132165868164546,90795,0.643224517555046
"penance",1,8.50123267873842e-05,13,0.000126757542073753,102558,12,0.000132165868164546,90795,0.643224517555046
"port",1,8.50123267873842e-05,13,0.000126757542073753,102558,12,0.000132165868164546,90795,0.643224517555046
"porte",1,8.50123267873842e-05,13,0.000126757542073753,102558,12,0.000132165868164546,90795,0.643224517555046
"li",3,0.000255036980362153,40,0.00039002320638078,102558,37,0.000407511426840685,90795,0.625840071134639
"fils",4,0.000340049307149537,54,0.000526531328614053,102558,50,0.000550691117352277,90795,0.617495536852844
"franc",2,0.000170024653574768,27,0.000263265664307026,102558,25,0.000275345558676139,90795,0.617495536852844
"oeuvre",2,0.000170024653574768,27,0.000263265664307026,102558,25,0.000275345558676139,90795,0.617495536852844
"chose",6,0.000510073960724305,81,0.000789796992921079,102558,75,0.000826036676028416,90795,0.617495536852844
"femme",6,0.000510073960724305,81,0.000789796992921079,102558,75,0.000826036676028416,90795,0.617495536852844
"Christ",5,0.000425061633936921,68,0.000663039450847325,102558,63,0.000693870807863869,90795,0.612594778623853
"hors",3,0.000255036980362153,42,0.000409524366699819,102558,39,0.000429539071534776,90795,0.59374570851235
"jor",3,0.000255036980362153,42,0.000409524366699819,102558,39,0.000429539071534776,90795,0.59374570851235
"tyran",3,0.000255036980362153,42,0.000409524366699819,102558,39,0.000429539071534776,90795,0.59374570851235
"personne",2,0.000170024653574768,28,0.000273016244466546,102558,26,0.000286359381023184,90795,0.59374570851235
"jardin",1,8.50123267873842e-05,14,0.000136508122233273,102558,13,0.000143179690511592,90795,0.59374570851235
"moins",1,8.50123267873842e-05,14,0.000136508122233273,102558,13,0.000143179690511592,90795,0.59374570851235
"prudhomme",5,0.000425061633936921,73,0.000711792351644923,102558,68,0.000748939919599097,90795,0.567551044901511
"fil",7,0.000595086287511689,104,0.00101406033659003,102558,97,0.00106834076766342,90795,0.557019169841483
"advenir",2,0.000170024653574768,30,0.000292517404785585,102558,28,0.000308387025717275,90795,0.551335300761468
"trèstous",2,0.000170024653574768,30,0.000292517404785585,102558,28,0.000308387025717275,90795,0.551335300761468
"mi",1,8.50123267873842e-05,15,0.000146258702392792,102558,14,0.000154193512858638,90795,0.551335300761468
"Rouen",1,8.50123267873842e-05,15,0.000146258702392792,102558,14,0.000154193512858638,90795,0.551335300761468
"seoir",1,8.50123267873842e-05,15,0.000146258702392792,102558,14,0.000154193512858638,90795,0.551335300761468
"conte",3,0.000255036980362153,46,0.000448526687337897,102558,43,0.000473594360922958,90795,0.538513549580968
"abbé",2,0.000170024653574768,31,0.000302267984945104,102558,29,0.000319400848064321,90795,0.532323738666245
"mortel",2,0.000170024653574768,31,0.000302267984945104,102558,29,0.000319400848064321,90795,0.532323738666245
"mal",11,0.000935135594661226,172,0.00167709978743735,102558,161,0.00177322539787433,90795,0.52736420072836
"avoir",144,0.0122417750573833,2264,0.0220753134811521,102558,2120,0.0233493033757365,90795,0.524288663365622
"ensemble",2,0.000170024653574768,32,0.000312018565104624,102558,30,0.000330414670411366,90795,0.514579614044036
"seror",1,8.50123267873842e-05,16,0.000156009282552312,102558,15,0.000165207335205683,90795,0.514579614044036
"ui",1,8.50123267873842e-05,16,0.000156009282552312,102558,15,0.000165207335205683,90795,0.514579614044036
"gens",6,0.000510073960724305,99,0.00096530743579243,102558,93,0.00102428547827524,90795,0.497980271655519
"heure",4,0.000340049307149537,66,0.000643538290528286,102558,62,0.000682856985516824,90795,0.497980271655519
"mot",3,0.000255036980362153,50,0.000487529007975975,102558,47,0.00051764965031114,90795,0.492682609191099
"corps",17,0.00144520955538553,286,0.00278866592562257,102558,269,0.00296271821135525,90795,0.487798518889328
"Jehan",2,0.000170024653574768,34,0.000331519725423663,102558,32,0.000352442315105457,90795,0.482418388166284
"Burgifier",1,8.50123267873842e-05,17,0.000165759862711831,102558,16,0.000176221157552729,90795,0.482418388166284
"sanc",1,8.50123267873842e-05,17,0.000165759862711831,102558,16,0.000176221157552729,90795,0.482418388166284
"table",1,8.50123267873842e-05,17,0.000165759862711831,102558,16,0.000176221157552729,90795,0.482418388166284
"uis",1,8.50123267873842e-05,17,0.000165759862711831,102558,16,0.000176221157552729,90795,0.482418388166284
"seignor",13,0.00110516024823599,223,0.00217437937557285,102558,210,0.00231290269287956,90795,0.477823927326605
"force",2,0.000170024653574768,36,0.000351020885742702,102558,34,0.000374469959799548,90795,0.454040835921209
"mille",2,0.000170024653574768,37,0.000360771465902221,102558,35,0.000385483782146594,90795,0.441068240609174
"nuit",4,0.000340049307149537,75,0.000731293511963962,102558,71,0.000781981386640233,90795,0.4348560118682
"dix",1,8.50123267873842e-05,19,0.00018526102303087,102558,18,0.00019824880224682,90795,0.428816345036697
"endroit",1,8.50123267873842e-05,19,0.00018526102303087,102558,18,0.00019824880224682,90795,0.428816345036697
"roi",22,0.00187027118932245,419,0.00408549308683867,102558,397,0.00437248747177708,90795,0.427736203109652
"beau",7,0.000595086287511689,135,0.00131632832153513,102558,128,0.00140976926042183,90795,0.422116089645499
"deuil",1,8.50123267873842e-05,20,0.00019501160319039,102558,19,0.000209262624593865,90795,0.406247063718976
"gentil",1,8.50123267873842e-05,20,0.00019501160319039,102558,19,0.000209262624593865,90795,0.406247063718976
"homme",12,0.00102014792144861,241,0.0023498898184442,102558,229,0.00252216531747343,90795,0.404473059073915
"être",28,0.00238034515004676,564,0.00549932720996899,102558,536,0.00590340877801641,90795,0.403215369213611
"ostel",1,8.50123267873842e-05,21,0.000204762183349909,102558,20,0.000220276446940911,90795,0.385934710533027
"haut",5,0.000425061633936921,106,0.00103356149690907,102558,101,0.0011123960570516,90795,0.382113574785175
"voix",3,0.000255036980362153,66,0.000643538290528286,102558,63,0.000693870807863869,90795,0.367556867174312
"archevêque",1,8.50123267873842e-05,22,0.000214512763509429,102558,21,0.000231290269287956,90795,0.367556867174312
"coeur",1,8.50123267873842e-05,22,0.000214512763509429,102558,21,0.000231290269287956,90795,0.367556867174312
"digne",1,8.50123267873842e-05,22,0.000214512763509429,102558,21,0.000231290269287956,90795,0.367556867174312
"nie",1,8.50123267873842e-05,22,0.000214512763509429,102558,21,0.000231290269287956,90795,0.367556867174312
"temps",3,0.000255036980362153,67,0.000653288870687806,102558,64,0.000704884630210915,90795,0.361813791124713
"trois",3,0.000255036980362153,68,0.000663039450847325,102558,65,0.00071589845255796,90795,0.35624742510741
"ainçois",1,8.50123267873842e-05,23,0.000224263343668948,102558,22,0.000242304091635002,90795,0.350849736848207
"chétif",1,8.50123267873842e-05,23,0.000224263343668948,102558,22,0.000242304091635002,90795,0.350849736848207
"devant",6,0.000510073960724305,139,0.00135533064217321,102558,133,0.00146483837215706,90795,0.348211768901979
"sus",3,0.000255036980362153,72,0.000702041771485403,102558,69,0.000759953741946142,90795,0.335595400463502
"nef",1,8.50123267873842e-05,24,0.000234013923828468,102558,23,0.000253317913982047,90795,0.335595400463502
"près",1,8.50123267873842e-05,24,0.000234013923828468,102558,23,0.000253317913982047,90795,0.335595400463502
"estre",105,0.00892629431267534,2537,0.0247372218647009,102558,2432,0.0267856159480148,90795,0.333249544456973
"âme",1,8.50123267873842e-05,25,0.000243764503987987,102558,24,0.000264331736329093,90795,0.321612258777523
"lors",10,0.000850123267873842,251,0.00244739562003939,102558,241,0.00265433118563798,90795,0.320277768077201
"tant",14,0.00119017257502338,359,0.0035004582772675,102558,345,0.00379976870973071,90795,0.313222373765935
"jamais",2,0.000170024653574768,52,0.000507030168295014,102558,50,0.000550691117352277,90795,0.308747768426422
"lonc",1,8.50123267873842e-05,26,0.000253515084147507,102558,25,0.000275345558676139,90795,0.308747768426422
"Sébastien",1,8.50123267873842e-05,26,0.000253515084147507,102558,25,0.000275345558676139,90795,0.308747768426422
"tous",11,0.000935135594661226,291,0.00283741882642017,102558,280,0.00308387025717275,90795,0.303234415418807
"grâce",2,0.000170024653574768,53,0.000516780748454533,102558,51,0.000561704939699323,90795,0.302693890614139
"Michel",1,8.50123267873842e-05,27,0.000263265664307026,102558,26,0.000286359381023184,90795,0.296872854256175
"bon",12,0.00102014792144861,344,0.00335419957487471,102558,332,0.00365658901921912,90795,0.278988947373273
"sembler",1,8.50123267873842e-05,29,0.000282766824626065,102558,28,0.000308387025717275,90795,0.275667650380734
"aussi",2,0.000170024653574768,59,0.00057528422941165,102558,57,0.000627787873781596,90795,0.270831375812651
"dieu",4,0.000340049307149537,119,0.00116031903898282,102558,115,0.00126658956991024,90795,0.268476320370802
"ermite",2,0.000170024653574768,61,0.000594785389730689,102558,59,0.000649815518475687,90795,0.261650651208832
"seigneur",3,0.000255036980362153,92,0.000897053374675793,102558,89,0.000980230188887053,90795,0.260180703730131
"Rome",2,0.000170024653574768,62,0.000604535969890208,102558,60,0.000660829340822732,90795,0.257289807022018
"conseil",1,8.50123267873842e-05,31,0.000302267984945104,102558,30,0.000330414670411366,90795,0.257289807022018
"pas",6,0.000510073960724305,188,0.00183310906998966,102558,182,0.00200451566716229,90795,0.254462446505293
"grant",20,0.00170024653574768,630,0.00614286550049728,102558,610,0.00671843163169778,90795,0.253071941333133
"nul",7,0.000595086287511689,222,0.00216462879541333,102558,215,0.00236797180461479,90795,0.251306323137785
"Angleterre",1,8.50123267873842e-05,32,0.000312018565104624,102558,31,0.000341428492758412,90795,0.24899013582776
"fer",1,8.50123267873842e-05,32,0.000312018565104624,102558,31,0.000341428492758412,90795,0.24899013582776
"ome",1,8.50123267873842e-05,32,0.000312018565104624,102558,31,0.000341428492758412,90795,0.24899013582776
"plusieurs",1,8.50123267873842e-05,32,0.000312018565104624,102558,31,0.000341428492758412,90795,0.24899013582776
"tel",5,0.000425061633936921,162,0.00157959398584216,102558,157,0.00172917010848615,90795,0.245818286963712
"doux",4,0.000340049307149537,130,0.00126757542073753,102558,126,0.00138774161572774,90795,0.245037911449541
"sur",3,0.000255036980362153,100,0.000975058015951949,102558,97,0.00106834076766342,90795,0.238722501360635
"forest",1,8.50123267873842e-05,34,0.000331519725423663,102558,33,0.000363456137452503,90795,0.233899824565471
"cel",5,0.000425061633936921,177,0.00172585268823495,102558,172,0.00189437744369183,90795,0.224380645658737
"eux",2,0.000170024653574768,71,0.000692291191325884,102558,69,0.000759953741946142,90795,0.223730266975668
"dedans",3,0.000255036980362153,108,0.00105306265722811,102558,105,0.00115645134643978,90795,0.220534120304587
"deux",5,0.000425061633936921,184,0.00179410674935159,102558,179,0.00197147420012115,90795,0.215605983538004
"diable",3,0.000255036980362153,112,0.00109206497786618,102558,109,0.00120050663582796,90795,0.212441125064052
"blanc",1,8.50123267873842e-05,38,0.000370522046061741,102558,37,0.000407511426840685,90795,0.20861335704488
"nous",4,0.000340049307149537,158,0.00154059166520408,102558,154,0.00169612864144501,90795,0.200485563913261
"cent",1,8.50123267873842e-05,41,0.000399773786540299,102558,40,0.000440552893881822,90795,0.192967355266514
"issi",1,8.50123267873842e-05,41,0.000399773786540299,102558,40,0.000440552893881822,90795,0.192967355266514
"Richard",3,0.000255036980362153,124,0.00120907193978042,102558,121,0.00133267250399251,90795,0.191372583735385
"on",6,0.000510073960724305,253,0.00246689678035843,102558,247,0.00272041411972025,90795,0.187498644793374
"Robert",3,0.000255036980362153,129,0.00125782484057801,102558,126,0.00138774161572774,90795,0.183778433587156
"cuer",4,0.000340049307149537,175,0.00170635152791591,102558,171,0.00188336362134479,90795,0.180554250541767
"Paul",1,8.50123267873842e-05,44,0.000429025527018858,102558,43,0.000473594360922958,90795,0.179504516526989
"ton",4,0.000340049307149537,179,0.00174535384855399,102558,175,0.00192741891073297,90795,0.17642729624367
"dame",5,0.000425061633936921,225,0.00219388053589189,102558,220,0.00242304091635002,90795,0.175424868424103
"contre",1,8.50123267873842e-05,45,0.000438776107178377,102558,44,0.000484608183270004,90795,0.175424868424103
"bien",14,0.00119017257502338,636,0.0062013689814544,102558,622,0.00685059749986233,90795,0.173732667120977
"lui",5,0.000425061633936921,228,0.00222313227637044,102558,223,0.00245608238339116,90795,0.173064892615707
"feme",1,8.50123267873842e-05,47,0.000458277267497416,102558,46,0.000506635827964095,90795,0.167797700231751
"tu",9,0.000765110941086458,448,0.00436825991146473,102558,439,0.00483506801035299,90795,0.158242022542016
"sor",1,8.50123267873842e-05,50,0.000487529007975975,102558,49,0.000539677295005232,90795,0.157524371646134
"évêque",1,8.50123267873842e-05,54,0.000526531328614053,102558,53,0.000583732584393414,90795,0.145635739823784
"nos",1,8.50123267873842e-05,55,0.000536281908773572,102558,54,0.000594746406740459,90795,0.142938781678899
"cest",3,0.000255036980362153,166,0.00161859630648024,102558,163,0.00179525304256842,90795,0.142061856637924
"sept",1,8.50123267873842e-05,58,0.00056553364925213,102558,57,0.000627787873781596,90795,0.135415687906325
"Dieu",11,0.000935135594661226,682,0.00664989566879229,102558,671,0.00739027479486756,90795,0.126535970666566
"mon",7,0.000595086287511689,472,0.0046022738352932,102558,465,0.00512142739137618,90795,0.116195396719621
"vers",1,8.50123267873842e-05,74,0.000721542931804442,102558,73,0.000804009031334325,90795,0.105735537132336
"duc",1,8.50123267873842e-05,88,0.000858051054037715,102558,87,0.000958202544192962,90795,0.0887206231110408
"tost",1,8.50123267873842e-05,98,0.00095555685563291,102558,97,0.00106834076766342,90795,0.0795741671202118
"or",2,0.000170024653574768,226,0.00220363111605141,102558,224,0.0024670962057382,90795,0.0689169125951834
"maint",1,8.50123267873842e-05,121,0.00117982019930186,102558,120,0.00132165868164546,90795,0.0643224517555046
"vous",6,0.000510073960724305,761,0.00742019150139433,102558,755,0.00831543587201939,90795,0.06134061624366
"saint",5,0.000425061633936921,707,0.00689366017278028,102558,702,0.00773170328762597,90795,0.0549764544918842
"tot",1,8.50123267873842e-05,155,0.00151133992472552,102558,154,0.00169612864144501,90795,0.0501213909783152
"soi",6,0.000510073960724305,974,0.00949706507537199,102558,968,0.0106613800319401,90795,0.0478431459338464
"il",20,0.00170024653574768,3679,0.0358723844068722,102558,3659,0.0402995759678396,90795,0.0421901842616045
"elle",1,8.50123267873842e-05,200,0.0019501160319039,102558,199,0.00219175064706206,90795,0.0387874080937716
"pour",3,0.000255036980362153,659,0.00642563232512334,102558,656,0.00722506745966188,90795,0.0352989064511915
"tout",2,0.000170024653574768,456,0.00444626455274089,102558,454,0.00500027534555868,90795,0.0340030581967425
"autre",1,8.50123267873842e-05,233,0.00227188517716804,102558,232,0.00255520678451457,90795,0.0332702336666403
"cant",1,8.50123267873842e-05,245,0.00238889213908228,102558,244,0.00268737265267911,90795,0.0316339926666416
"cil",1,8.50123267873842e-05,246,0.00239864271924179,102558,245,0.00269838647502616,90795,0.0315048743292267
"a",9,0.000765110941086458,2257,0.0220070594200355,102558,2248,0.0247590726361584,90795,0.0309022455053136
"je",5,0.000425061633936921,1329,0.0129585210320014,102558,1324,0.0145823007874883,90795,0.0291491473212256
"plus",1,8.50123267873842e-05,267,0.0026034049025917,102558,266,0.00292967674431411,90795,0.0290176474084983
"mais",2,0.000170024653574768,550,0.00536281908773572,102558,548,0.00603557464618096,90795,0.0281704168272283
"moult",1,8.50123267873842e-05,332,0.00323719261296047,102558,331,0.00364557519687207,90795,0.0233193178569805
"son",4,0.000340049307149537,1643,0.0160202032020905,102558,1639,0.0180516548268076,90795,0.0188375697636621
"un",2,0.000170024653574768,1008,0.00982858480079565,102558,1006,0.0110799052811278,90795,0.015345316522188
"le",1,8.50123267873842e-05,5606,0.0546617523742663,102558,5605,0.0617324742551903,90795,0.0013771086905728
