"lemma","count_final","rate_final","count_all","rate_all","vs_all","count_not_final","rate_not_final","vs_not_final","diff_rates"
"demeurée",11,0.00104991886990551,11,0.000120448946071722,91325,0,0,80848,Inf
"embraser",10,0.000954471699914098,10,0.000109499041883384,91325,0,0,80848,Inf
"honorer",14,0.00133626037987974,15,0.000164248562825075,91325,1,1.23688897684544e-05,80848,108.033979192517
"passion",11,0.00104991886990551,12,0.00013139885026006,91325,1,1.23688897684544e-05,80848,84.8838407941205
"lumière",9,0.000859024529922688,10,0.000109499041883384,91325,1,1.23688897684544e-05,80848,69.4504151951895
"oublier",9,0.000859024529922688,10,0.000109499041883384,91325,1,1.23688897684544e-05,80848,69.4504151951895
"saisir",15,0.00143170754987115,18,0.00019709827539009,91325,3,3.71066693053632e-05,80848,38.5835639973275
"appareiller",10,0.000954471699914098,12,0.00013139885026006,91325,2,2.47377795369088e-05,80848,38.5835639973275
"contraire",10,0.000954471699914098,12,0.00013139885026006,91325,2,2.47377795369088e-05,80848,38.5835639973275
"droiture",10,0.000954471699914098,12,0.00013139885026006,91325,2,2.47377795369088e-05,80848,38.5835639973275
"folie",19,0.00181349622983679,23,0.000251847796331782,91325,4,4.94755590738175e-05,80848,36.6543857974611
"prouver",9,0.000859024529922688,11,0.000120448946071722,91325,2,2.47377795369088e-05,80848,34.7252075975947
"retraire",17,0.00162260188985397,21,0.000229947987955105,91325,4,4.94755590738175e-05,80848,32.7960293977284
"remüer",8,0.000763577359931278,10,0.000109499041883384,91325,2,2.47377795369088e-05,80848,30.866851197862
"vis",8,0.000763577359931278,10,0.000109499041883384,91325,2,2.47377795369088e-05,80848,30.866851197862
"departir",11,0.00104991886990551,14,0.000153298658636737,91325,3,3.71066693053632e-05,80848,28.2946135980402
"esgarder",11,0.00104991886990551,14,0.000153298658636737,91325,3,3.71066693053632e-05,80848,28.2946135980402
"desservir",10,0.000954471699914098,13,0.000142348754448399,91325,3,3.71066693053632e-05,80848,25.7223759982183
"ébahir",23,0.00219528490980242,30,0.000328497125650151,91325,7,8.65822283791807e-05,80848,25.3549134839581
"courage",13,0.00124081320988833,17,0.000186148371201752,91325,4,4.94755590738175e-05,80848,25.0793165982629
"respit",13,0.00124081320988833,17,0.000186148371201752,91325,4,4.94755590738175e-05,80848,25.0793165982629
"celer",16,0.00152715471986256,21,0.000229947987955105,91325,5,6.18444488422719e-05,80848,24.6934809582896
"envie",12,0.00114536603989692,16,0.000175198467013414,91325,4,4.94755590738175e-05,80848,23.1501383983965
"deviser",9,0.000859024529922688,12,0.00013139885026006,91325,3,3.71066693053632e-05,80848,23.1501383983965
"mari",9,0.000859024529922688,12,0.00013139885026006,91325,3,3.71066693053632e-05,80848,23.1501383983965
"tendre",9,0.000859024529922688,12,0.00013139885026006,91325,3,3.71066693053632e-05,80848,23.1501383983965
"poissant",25,0.00238617924978524,34,0.000372296742403504,91325,9,0.000111320007916089,80848,21.4353133318486
"pensée",16,0.00152715471986256,22,0.000240897892143444,91325,6,7.42133386107263e-05,80848,20.5779007985747
"tourmenter",16,0.00152715471986256,22,0.000240897892143444,91325,6,7.42133386107263e-05,80848,20.5779007985747
"compagnie",23,0.00219528490980242,32,0.000350396934026827,91325,9,0.000111320007916089,80848,19.7204882653007
"doter",7,0.000668130189939868,10,0.000109499041883384,91325,3,3.71066693053632e-05,80848,18.0056631987528
"fondre",7,0.000668130189939868,10,0.000109499041883384,91325,3,3.71066693053632e-05,80848,18.0056631987528
"réjouir",7,0.000668130189939868,10,0.000109499041883384,91325,3,3.71066693053632e-05,80848,18.0056631987528
"journée",16,0.00152715471986256,23,0.000251847796331782,91325,7,8.65822283791807e-05,80848,17.6382006844926
"afaire",9,0.000859024529922688,13,0.000142348754448399,91325,4,4.94755590738175e-05,80848,17.3626037987974
"bonté",11,0.00104991886990551,16,0.000175198467013414,91325,5,6.18444488422719e-05,80848,16.9767681588241
"nature",11,0.00104991886990551,16,0.000175198467013414,91325,5,6.18444488422719e-05,80848,16.9767681588241
"atendre",13,0.00124081320988833,19,0.000208048179578429,91325,6,7.42133386107263e-05,80848,16.7195443988419
"entier",13,0.00124081320988833,19,0.000208048179578429,91325,6,7.42133386107263e-05,80848,16.7195443988419
"bonnement",8,0.000763577359931278,12,0.00013139885026006,91325,4,4.94755590738175e-05,80848,15.433425598931
"cure",12,0.00114536603989692,18,0.00019709827539009,91325,6,7.42133386107263e-05,80848,15.433425598931
"plaisir",12,0.00114536603989692,18,0.00019709827539009,91325,6,7.42133386107263e-05,80848,15.433425598931
"naistre",31,0.0029588622697337,47,0.000514645496851902,91325,16,0.00019790223629527,80848,14.9511310489644
"partie",15,0.00143170754987115,23,0.000251847796331782,91325,8,9.89511181476351e-05,80848,14.4688364989978
"aviser",13,0.00124081320988833,20,0.000218998083766767,91325,7,8.65822283791807e-05,80848,14.3310380561502
"débonnaire",11,0.00104991886990551,17,0.000186148371201752,91325,6,7.42133386107263e-05,80848,14.1473067990201
"taire",11,0.00104991886990551,17,0.000186148371201752,91325,6,7.42133386107263e-05,80848,14.1473067990201
"vraiment",11,0.00104991886990551,17,0.000186148371201752,91325,6,7.42133386107263e-05,80848,14.1473067990201
"fier",9,0.000859024529922688,14,0.000153298658636737,91325,5,6.18444488422719e-05,80848,13.8900830390379
"présent",9,0.000859024529922688,14,0.000153298658636737,91325,5,6.18444488422719e-05,80848,13.8900830390379
"souverain",9,0.000859024529922688,14,0.000153298658636737,91325,5,6.18444488422719e-05,80848,13.8900830390379
"étendre",7,0.000668130189939868,11,0.000120448946071722,91325,4,4.94755590738175e-05,80848,13.5042473990646
"pener",7,0.000668130189939868,11,0.000120448946071722,91325,4,4.94755590738175e-05,80848,13.5042473990646
"mie",59,0.00563138302949318,94,0.0010292909937038,91325,35,0.000432911141895903,80848,13.0081730048133
"aventure",10,0.000954471699914098,16,0.000175198467013414,91325,6,7.42133386107263e-05,80848,12.8611879991092
"défendre",10,0.000954471699914098,16,0.000175198467013414,91325,6,7.42133386107263e-05,80848,12.8611879991092
"aimer",18,0.00171804905984538,29,0.000317547221461812,91325,11,0.000136057787452998,80848,12.6273482173072
"mentir",20,0.0019089433998282,33,0.000361346838215166,91325,13,0.000160795566989907,80848,11.8718658453315
"clamer",15,0.00143170754987115,25,0.000273747604708459,91325,10,0.000123688897684544,80848,11.5750691991982
"confort",6,0.000572683019948459,10,0.000109499041883384,91325,4,4.94755590738175e-05,80848,11.5750691991982
"épouser",6,0.000572683019948459,10,0.000109499041883384,91325,4,4.94755590738175e-05,80848,11.5750691991982
"eschaper",6,0.000572683019948459,10,0.000109499041883384,91325,4,4.94755590738175e-05,80848,11.5750691991982
"former",6,0.000572683019948459,10,0.000109499041883384,91325,4,4.94755590738175e-05,80848,11.5750691991982
"guerpir",6,0.000572683019948459,10,0.000109499041883384,91325,4,4.94755590738175e-05,80848,11.5750691991982
"lez",6,0.000572683019948459,10,0.000109499041883384,91325,4,4.94755590738175e-05,80848,11.5750691991982
"livrer",6,0.000572683019948459,10,0.000109499041883384,91325,4,4.94755590738175e-05,80848,11.5750691991982
"ordonner",6,0.000572683019948459,10,0.000109499041883384,91325,4,4.94755590738175e-05,80848,11.5750691991982
"plenté",6,0.000572683019948459,10,0.000109499041883384,91325,4,4.94755590738175e-05,80848,11.5750691991982
"sauvage",6,0.000572683019948459,10,0.000109499041883384,91325,4,4.94755590738175e-05,80848,11.5750691991982
"tramettre",6,0.000572683019948459,10,0.000109499041883384,91325,4,4.94755590738175e-05,80848,11.5750691991982
"chiere",10,0.000954471699914098,17,0.000186148371201752,91325,7,8.65822283791807e-05,80848,11.0238754278079
"dolor",10,0.000954471699914098,17,0.000186148371201752,91325,7,8.65822283791807e-05,80848,11.0238754278079
"matiere",10,0.000954471699914098,17,0.000186148371201752,91325,7,8.65822283791807e-05,80848,11.0238754278079
"remanoir",10,0.000954471699914098,17,0.000186148371201752,91325,7,8.65822283791807e-05,80848,11.0238754278079
"äie",7,0.000668130189939868,12,0.00013139885026006,91325,5,6.18444488422719e-05,80848,10.8033979192517
"arriver",7,0.000668130189939868,12,0.00013139885026006,91325,5,6.18444488422719e-05,80848,10.8033979192517
"grever",7,0.000668130189939868,12,0.00013139885026006,91325,5,6.18444488422719e-05,80848,10.8033979192517
"sonner",7,0.000668130189939868,12,0.00013139885026006,91325,5,6.18444488422719e-05,80848,10.8033979192517
"vain",7,0.000668130189939868,12,0.00013139885026006,91325,5,6.18444488422719e-05,80848,10.8033979192517
"aporter",8,0.000763577359931278,14,0.000153298658636737,91325,6,7.42133386107263e-05,80848,10.2889503992873
"coucher",8,0.000763577359931278,14,0.000153298658636737,91325,6,7.42133386107263e-05,80848,10.2889503992873
"lever",26,0.00248162641977665,46,0.000503695592663564,91325,20,0.000247377795369088,80848,10.0317266393051
"assembler",13,0.00124081320988833,23,0.000251847796331782,91325,10,0.000123688897684544,80848,10.0317266393051
"douleur",14,0.00133626037987974,25,0.000273747604708459,91325,11,0.000136057787452998,80848,9.82127083568336
"appeler",20,0.0019089433998282,36,0.000394196550780181,91325,16,0.00019790223629527,80848,9.64589099933187
"contree",15,0.00143170754987115,27,0.000295647413085135,91325,12,0.000148426677221453,80848,9.64589099933187
"pendre",15,0.00143170754987115,27,0.000295647413085135,91325,12,0.000148426677221453,80848,9.64589099933187
"torner",11,0.00104991886990551,20,0.000218998083766767,91325,9,0.000111320007916089,80848,9.43153786601338
"trépasser",11,0.00104991886990551,20,0.000218998083766767,91325,9,0.000111320007916089,80848,9.43153786601338
"attendre",12,0.00114536603989692,22,0.000240897892143444,91325,10,0.000123688897684544,80848,9.2600553593586
"accorder",6,0.000572683019948459,11,0.000120448946071722,91325,5,6.18444488422719e-05,80848,9.2600553593586
"durer",6,0.000572683019948459,11,0.000120448946071722,91325,5,6.18444488422719e-05,80848,9.2600553593586
"pardon",6,0.000572683019948459,11,0.000120448946071722,91325,5,6.18444488422719e-05,80848,9.2600553593586
"raconter",6,0.000572683019948459,11,0.000120448946071722,91325,5,6.18444488422719e-05,80848,9.2600553593586
"semblant",6,0.000572683019948459,11,0.000120448946071722,91325,5,6.18444488422719e-05,80848,9.2600553593586
"baptiser",7,0.000668130189939868,13,0.000142348754448399,91325,6,7.42133386107263e-05,80848,9.00283159937641
"vilain",7,0.000668130189939868,13,0.000142348754448399,91325,6,7.42133386107263e-05,80848,9.00283159937641
"Marie",24,0.00229073207979383,45,0.000492745688475226,91325,21,0.000259746685137542,80848,8.81910034224628
"demener",9,0.000859024529922688,17,0.000186148371201752,91325,8,9.89511181476351e-05,80848,8.68130189939868
"envoiier",9,0.000859024529922688,17,0.000186148371201752,91325,8,9.89511181476351e-05,80848,8.68130189939868
"Normandie",9,0.000859024529922688,17,0.000186148371201752,91325,8,9.89511181476351e-05,80848,8.68130189939868
"octroyer",12,0.00114536603989692,23,0.000251847796331782,91325,11,0.000136057787452998,80848,8.41823214487145
"demander",26,0.00248162641977665,51,0.000558445113605256,91325,25,0.00030922224421136,80848,8.02538131144412
"chanter",14,0.00133626037987974,28,0.000306597317273474,91325,14,0.000173164456758361,80848,7.7167127994655
"nourrir",14,0.00133626037987974,28,0.000306597317273474,91325,14,0.000173164456758361,80848,7.7167127994655
"tenter",14,0.00133626037987974,28,0.000306597317273474,91325,14,0.000173164456758361,80848,7.7167127994655
"volonté",13,0.00124081320988833,26,0.000284697508896797,91325,13,0.000160795566989907,80848,7.7167127994655
"vestir",10,0.000954471699914098,20,0.000218998083766767,91325,10,0.000123688897684544,80848,7.7167127994655
"reposer",9,0.000859024529922688,18,0.00019709827539009,91325,9,0.000111320007916089,80848,7.7167127994655
"finer",8,0.000763577359931278,16,0.000175198467013414,91325,8,9.89511181476351e-05,80848,7.7167127994655
"maintenir",8,0.000763577359931278,16,0.000175198467013414,91325,8,9.89511181476351e-05,80848,7.7167127994655
"ovrer",8,0.000763577359931278,16,0.000175198467013414,91325,8,9.89511181476351e-05,80848,7.7167127994655
"avis",7,0.000668130189939868,14,0.000153298658636737,91325,7,8.65822283791807e-05,80848,7.7167127994655
"ester",7,0.000668130189939868,14,0.000153298658636737,91325,7,8.65822283791807e-05,80848,7.7167127994655
"accomplir",5,0.000477235849957049,10,0.000109499041883384,91325,5,6.18444488422719e-05,80848,7.7167127994655
"apporter",5,0.000477235849957049,10,0.000109499041883384,91325,5,6.18444488422719e-05,80848,7.7167127994655
"commandement",5,0.000477235849957049,10,0.000109499041883384,91325,5,6.18444488422719e-05,80848,7.7167127994655
"douceur",5,0.000477235849957049,10,0.000109499041883384,91325,5,6.18444488422719e-05,80848,7.7167127994655
"engendrer",5,0.000477235849957049,10,0.000109499041883384,91325,5,6.18444488422719e-05,80848,7.7167127994655
"jugement",5,0.000477235849957049,10,0.000109499041883384,91325,5,6.18444488422719e-05,80848,7.7167127994655
"louer",5,0.000477235849957049,10,0.000109499041883384,91325,5,6.18444488422719e-05,80848,7.7167127994655
"obéir",5,0.000477235849957049,10,0.000109499041883384,91325,5,6.18444488422719e-05,80848,7.7167127994655
"ouvrir",5,0.000477235849957049,10,0.000109499041883384,91325,5,6.18444488422719e-05,80848,7.7167127994655
"plorer",5,0.000477235849957049,10,0.000109499041883384,91325,5,6.18444488422719e-05,80848,7.7167127994655
"puant",5,0.000477235849957049,10,0.000109499041883384,91325,5,6.18444488422719e-05,80848,7.7167127994655
"service",5,0.000477235849957049,10,0.000109499041883384,91325,5,6.18444488422719e-05,80848,7.7167127994655
"guérir",6,0.000572683019948459,12,0.00013139885026006,91325,6,7.42133386107263e-05,80848,7.71671279946549
"demeurer",35,0.00334065094969934,72,0.000788393101560361,91325,37,0.000457648921432812,80848,7.29959318868358
"tourment",21,0.0020043905698196,44,0.000481795784286887,91325,23,0.000284484464674451,80848,7.04569429516415
"aorer",10,0.000954471699914098,21,0.000229947987955105,91325,11,0.000136057787452998,80848,7.01519345405954
"conter",29,0.00276796792975088,61,0.00066794415548864,91325,32,0.00039580447259054,80848,6.99327097451561
"assëoir",9,0.000859024529922688,19,0.000208048179578429,91325,10,0.000123688897684544,80848,6.94504151951895
"prisier",9,0.000859024529922688,19,0.000208048179578429,91325,10,0.000123688897684544,80848,6.94504151951895
"sage",16,0.00152715471986256,34,0.000372296742403504,91325,18,0.000222640015832179,80848,6.85930026619155
"écriture",8,0.000763577359931278,17,0.000186148371201752,91325,9,0.000111320007916089,80848,6.85930026619155
"néant",8,0.000763577359931278,17,0.000186148371201752,91325,9,0.000111320007916089,80848,6.85930026619155
"poissance",7,0.000668130189939868,15,0.000164248562825075,91325,8,9.89511181476351e-05,80848,6.75212369953231
"manière",17,0.00162260188985397,37,0.000405146454968519,91325,20,0.000247377795369088,80848,6.55920587954567
"sauver",11,0.00104991886990551,24,0.00026279770052012,91325,13,0.000160795566989907,80848,6.52952621493234
"escouter",10,0.000954471699914098,22,0.000240897892143444,91325,12,0.000148426677221453,80848,6.43059399955458
"férir",5,0.000477235849957049,11,0.000120448946071722,91325,6,7.42133386107263e-05,80848,6.43059399955458
"foison",5,0.000477235849957049,11,0.000120448946071722,91325,6,7.42133386107263e-05,80848,6.43059399955458
"couchier",14,0.00133626037987974,31,0.000339447029838489,91325,17,0.000210271126063725,80848,6.354939952501
"aprendre",9,0.000859024529922688,20,0.000218998083766767,91325,11,0.000136057787452998,80848,6.31367410865359
"pardonner",9,0.000859024529922688,20,0.000218998083766767,91325,11,0.000136057787452998,80848,6.31367410865359
"maison",13,0.00124081320988833,29,0.000317547221461812,91325,16,0.00019790223629527,80848,6.26982914956572
"vie",60,0.00572683019948459,134,0.00146728716123734,91325,74,0.000915297842865624,80848,6.25679416172878
"mener",45,0.00429512264961344,101,0.00110594032302217,91325,56,0.000692657827033445,80848,6.20092992814192
"raison",24,0.00229073207979383,54,0.000591294826170271,91325,30,0.000371066693053631,80848,6.1733702395724
"amener",16,0.00152715471986256,36,0.000394196550780181,91325,20,0.000247377795369088,80848,6.1733702395724
"dolent",12,0.00114536603989692,27,0.000295647413085135,91325,15,0.000185533346526816,80848,6.1733702395724
"talent",12,0.00114536603989692,27,0.000295647413085135,91325,15,0.000185533346526816,80848,6.1733702395724
"chrétienté",8,0.000763577359931278,18,0.00019709827539009,91325,10,0.000123688897684544,80848,6.1733702395724
"merci",23,0.00219528490980242,52,0.000569395017793594,91325,29,0.000358697803285177,80848,6.12015153061057
"monter",15,0.00143170754987115,34,0.000372296742403504,91325,19,0.000235008905600633,80848,6.09214168378855
"ami",62,0.0059177245394674,141,0.00154393649055571,91325,79,0.000977142291707896,80848,6.05615434894761
"passer",21,0.0020043905698196,48,0.000525595401040241,91325,27,0.000333960023748268,80848,6.00188773291761
"cesser",7,0.000668130189939868,16,0.000175198467013414,91325,9,0.000111320007916089,80848,6.00188773291761
"déprier",7,0.000668130189939868,16,0.000175198467013414,91325,9,0.000111320007916089,80848,6.00188773291761
"endormir",7,0.000668130189939868,16,0.000175198467013414,91325,9,0.000111320007916089,80848,6.00188773291761
"lié",10,0.000954471699914098,23,0.000251847796331782,91325,13,0.000160795566989907,80848,5.93593292266577
"verité",12,0.00114536603989692,28,0.000306597317273474,91325,16,0.00019790223629527,80848,5.78753459959912
"aidier",6,0.000572683019948459,14,0.000153298658636737,91325,8,9.89511181476351e-05,80848,5.78753459959912
"clarté",6,0.000572683019948459,14,0.000153298658636737,91325,8,9.89511181476351e-05,80848,5.78753459959912
"decevoir",6,0.000572683019948459,14,0.000153298658636737,91325,8,9.89511181476351e-05,80848,5.78753459959912
"dévotement",6,0.000572683019948459,14,0.000153298658636737,91325,8,9.89511181476351e-05,80848,5.78753459959912
"embattre",6,0.000572683019948459,14,0.000153298658636737,91325,8,9.89511181476351e-05,80848,5.78753459959912
"guerre",6,0.000572683019948459,14,0.000153298658636737,91325,8,9.89511181476351e-05,80848,5.78753459959912
"hoir",6,0.000572683019948459,14,0.000153298658636737,91325,8,9.89511181476351e-05,80848,5.78753459959912
"humilité",6,0.000572683019948459,14,0.000153298658636737,91325,8,9.89511181476351e-05,80848,5.78753459959912
"départir",9,0.000859024529922688,21,0.000229947987955105,91325,12,0.000148426677221453,80848,5.78753459959912
"voie",9,0.000859024529922688,21,0.000229947987955105,91325,12,0.000148426677221453,80848,5.78753459959912
"argent",11,0.00104991886990551,26,0.000284697508896797,91325,15,0.000185533346526816,80848,5.65892271960803
"tort",11,0.00104991886990551,26,0.000284697508896797,91325,15,0.000185533346526816,80848,5.65892271960803
"apercevoir",8,0.000763577359931278,19,0.000208048179578429,91325,11,0.000136057787452998,80848,5.61215476324763
"clair",8,0.000763577359931278,19,0.000208048179578429,91325,11,0.000136057787452998,80848,5.61215476324763
"martire",8,0.000763577359931278,19,0.000208048179578429,91325,11,0.000136057787452998,80848,5.61215476324763
"povoir",8,0.000763577359931278,19,0.000208048179578429,91325,11,0.000136057787452998,80848,5.61215476324763
"sëoir",8,0.000763577359931278,19,0.000208048179578429,91325,11,0.000136057787452998,80848,5.61215476324763
"écrire",13,0.00124081320988833,31,0.000339447029838489,91325,18,0.000222640015832179,80848,5.57318146628064
"fuir",13,0.00124081320988833,31,0.000339447029838489,91325,18,0.000222640015832179,80848,5.57318146628064
"ouvrer",5,0.000477235849957049,12,0.00013139885026006,91325,7,8.65822283791807e-05,80848,5.51193771390393
"prison",5,0.000477235849957049,12,0.00013139885026006,91325,7,8.65822283791807e-05,80848,5.51193771390393
"virginité",5,0.000477235849957049,12,0.00013139885026006,91325,7,8.65822283791807e-05,80848,5.51193771390393
"amer",35,0.00334065094969934,85,0.00093074185600876,91325,50,0.000618444488422719,80848,5.40169895962585
"descendre",14,0.00133626037987974,34,0.000372296742403504,91325,20,0.000247377795369088,80848,5.40169895962585
"mestier",7,0.000668130189939868,17,0.000186148371201752,91325,10,0.000123688897684544,80848,5.40169895962585
"retourner",23,0.00219528490980242,56,0.000613194634546948,91325,33,0.000408173362358995,80848,5.37831498144565
"parler",53,0.00505870000954472,130,0.00142348754448399,91325,77,0.000952404512170987,80848,5.31150361521651
"nommer",22,0.00209983773981101,54,0.000591294826170271,91325,32,0.00039580447259054,80848,5.30524004963253
"regarder",26,0.00248162641977665,64,0.000700793868053655,91325,38,0.000470017811201267,80848,5.27985612595008
"pleurer",23,0.00219528490980242,57,0.000624144538735286,91325,34,0.000420542252127449,80848,5.22012924669725
"chier",18,0.00171804905984538,45,0.000492745688475226,91325,27,0.000333960023748268,80848,5.14447519964366
"errer",10,0.000954471699914098,25,0.000273747604708459,91325,15,0.000185533346526816,80848,5.14447519964366
"tourner",10,0.000954471699914098,25,0.000273747604708459,91325,15,0.000185533346526816,80848,5.14447519964366
"trouver",62,0.0059177245394674,155,0.00169723514919244,91325,93,0.00115030674846626,80848,5.14447519964366
"mander",16,0.00152715471986256,40,0.000437996167533534,91325,24,0.000296853354442905,80848,5.14447519964366
"salir",6,0.000572683019948459,15,0.000164248562825075,91325,9,0.000111320007916089,80848,5.14447519964366
"lier",4,0.000381788679965639,10,0.000109499041883384,91325,6,7.42133386107263e-05,80848,5.14447519964366
"loyer",4,0.000381788679965639,10,0.000109499041883384,91325,6,7.42133386107263e-05,80848,5.14447519964366
"nouvelle",4,0.000381788679965639,10,0.000109499041883384,91325,6,7.42133386107263e-05,80848,5.14447519964366
"peser",4,0.000381788679965639,10,0.000109499041883384,91325,6,7.42133386107263e-05,80848,5.14447519964366
"rompre",7,0.000668130189939868,18,0.00019709827539009,91325,11,0.000136057787452998,80848,4.91063541784168
"escrïer",5,0.000477235849957049,13,0.000142348754448399,91325,8,9.89511181476351e-05,80848,4.82294549966594
"loyal",5,0.000477235849957049,13,0.000142348754448399,91325,8,9.89511181476351e-05,80848,4.82294549966594
"porter",34,0.00324520377970793,89,0.000974541472762113,91325,55,0.000680288937264991,80848,4.77033154876049
"baron",8,0.000763577359931278,21,0.000229947987955105,91325,13,0.000160795566989907,80848,4.74874633813261
"certain",14,0.00133626037987974,37,0.000405146454968519,91325,23,0.000284484464674451,80848,4.69712953010943
"sentir",9,0.000859024529922688,24,0.00026279770052012,91325,15,0.000185533346526816,80848,4.6300276796793
"seulement",6,0.000572683019948459,16,0.000175198467013414,91325,10,0.000123688897684544,80848,4.6300276796793
"paradis",19,0.00181349622983679,52,0.000569395017793594,91325,33,0.000408173362358995,80848,4.44295585423771
"metre",44,0.00419967547962203,121,0.00132493840678894,91325,77,0.000952404512170987,80848,4.40955017112314
"commander",20,0.0019089433998282,55,0.000602244730358609,91325,35,0.000432911141895903,80848,4.40955017112314
"lire",8,0.000763577359931278,22,0.000240897892143444,91325,14,0.000173164456758361,80848,4.40955017112314
"naître",8,0.000763577359931278,22,0.000240897892143444,91325,14,0.000173164456758361,80848,4.40955017112314
"avenir",4,0.000381788679965639,11,0.000120448946071722,91325,7,8.65822283791807e-05,80848,4.40955017112314
"bailler",4,0.000381788679965639,11,0.000120448946071722,91325,7,8.65822283791807e-05,80848,4.40955017112314
"laissier",4,0.000381788679965639,11,0.000120448946071722,91325,7,8.65822283791807e-05,80848,4.40955017112314
"menu",4,0.000381788679965639,11,0.000120448946071722,91325,7,8.65822283791807e-05,80848,4.40955017112314
"mois",4,0.000381788679965639,11,0.000120448946071722,91325,7,8.65822283791807e-05,80848,4.40955017112314
"venger",4,0.000381788679965639,11,0.000120448946071722,91325,7,8.65822283791807e-05,80848,4.40955017112314
"vision",4,0.000381788679965639,11,0.000120448946071722,91325,7,8.65822283791807e-05,80848,4.40955017112314
"prière",9,0.000859024529922688,25,0.000273747604708459,91325,16,0.00019790223629527,80848,4.34065094969934
"tolir",9,0.000859024529922688,25,0.000273747604708459,91325,16,0.00019790223629527,80848,4.34065094969934
"jeter",19,0.00181349622983679,53,0.000580344921981933,91325,34,0.000420542252127449,80848,4.31228068205425
"lignage",5,0.000477235849957049,14,0.000153298658636737,91325,9,0.000111320007916089,80848,4.28706266636972
"apeler",16,0.00152715471986256,45,0.000492745688475226,91325,29,0.000358697803285177,80848,4.25749671694648
"batre",6,0.000572683019948459,17,0.000186148371201752,91325,11,0.000136057787452998,80848,4.20911607243572
"fontaine",6,0.000572683019948459,17,0.000186148371201752,91325,11,0.000136057787452998,80848,4.20911607243572
"löer",6,0.000572683019948459,17,0.000186148371201752,91325,11,0.000136057787452998,80848,4.20911607243572
"hautement",7,0.000668130189939868,20,0.000218998083766767,91325,13,0.000160795566989907,80848,4.15515304586604
"päis",8,0.000763577359931278,23,0.000251847796331782,91325,15,0.000185533346526816,80848,4.11558015971493
"morir",11,0.00104991886990551,32,0.000350396934026827,91325,21,0.000259746685137542,80848,4.04208765686288
"rendre",24,0.00229073207979383,70,0.000766493293183685,91325,46,0.000568968929348902,80848,4.02611102580808
"fïer",12,0.00114536603989692,35,0.000383246646591842,91325,23,0.000284484464674451,80848,4.02611102580808
"ardre",15,0.00143170754987115,44,0.000481795784286887,91325,29,0.000358697803285177,80848,3.99140317213733
"pitié",17,0.00162260188985397,50,0.000547495209416918,91325,33,0.000408173362358995,80848,3.97527629063374
"vertu",11,0.00104991886990551,33,0.000361346838215166,91325,22,0.000272115574905996,80848,3.85835639973275
"recevoir",13,0.00124081320988833,39,0.000427046263345196,91325,26,0.000321591133979814,80848,3.85835639973275
"espee",9,0.000859024529922688,27,0.000295647413085135,91325,18,0.000222640015832179,80848,3.85835639973275
"recorder",7,0.000668130189939868,21,0.000229947987955105,91325,14,0.000173164456758361,80848,3.85835639973275
"guise",5,0.000477235849957049,15,0.000164248562825075,91325,10,0.000123688897684544,80848,3.85835639973275
"occire",5,0.000477235849957049,15,0.000164248562825075,91325,10,0.000123688897684544,80848,3.85835639973275
"chasser",4,0.000381788679965639,12,0.00013139885026006,91325,8,9.89511181476351e-05,80848,3.85835639973275
"image",4,0.000381788679965639,12,0.00013139885026006,91325,8,9.89511181476351e-05,80848,3.85835639973275
"ost",4,0.000381788679965639,12,0.00013139885026006,91325,8,9.89511181476351e-05,80848,3.85835639973275
"vendre",4,0.000381788679965639,12,0.00013139885026006,91325,8,9.89511181476351e-05,80848,3.85835639973275
"crïer",12,0.00114536603989692,36,0.000394196550780181,91325,24,0.000296853354442905,80848,3.85835639973275
"chemin",6,0.000572683019948459,18,0.00019709827539009,91325,12,0.000148426677221453,80848,3.85835639973275
"reclamer",6,0.000572683019948459,18,0.00019709827539009,91325,12,0.000148426677221453,80848,3.85835639973275
"entrer",24,0.00229073207979383,73,0.0007993430057487,91325,49,0.000606075598654265,80848,3.77961443239126
"perdre",20,0.0019089433998282,61,0.00066794415548864,91325,41,0.00050712448050663,80848,3.76425014608073
"entendre",46,0.00439056981960485,142,0.00155488639474405,91325,96,0.00118741341777162,80848,3.69759154974388
"partir",18,0.00171804905984538,56,0.000613194634546948,91325,38,0.000470017811201267,80848,3.65528501027313
"devenir",8,0.000763577359931278,25,0.000273747604708459,91325,17,0.000210271126063725,80848,3.631394258572
"issir",18,0.00171804905984538,57,0.000624144538735286,91325,39,0.000482386700969721,80848,3.56155975359946
"dormir",12,0.00114536603989692,38,0.000416096359156857,91325,26,0.000321591133979814,80848,3.56155975359946
"bouter",6,0.000572683019948459,19,0.000208048179578429,91325,13,0.000160795566989907,80848,3.56155975359946
"convertir",6,0.000572683019948459,19,0.000208048179578429,91325,13,0.000160795566989907,80848,3.56155975359946
"avant",15,0.00143170754987115,48,0.000525595401040241,91325,33,0.000408173362358995,80848,3.50759672702977
"manoir",5,0.000477235849957049,16,0.000175198467013414,91325,11,0.000136057787452998,80848,3.50759672702977
"plein",18,0.00171804905984538,58,0.000635094442923624,91325,40,0.000494755590738175,80848,3.47252075975947
"vif",9,0.000859024529922688,29,0.000317547221461812,91325,20,0.000247377795369088,80848,3.47252075975947
"endurer",8,0.000763577359931278,26,0.000284697508896797,91325,18,0.000222640015832179,80848,3.42965013309578
"querre",15,0.00143170754987115,49,0.000536545305228579,91325,34,0.000420542252127449,80848,3.40443211741125
"esposer",7,0.000668130189939868,23,0.000251847796331782,91325,16,0.00019790223629527,80848,3.37606184976615
"faim",7,0.000668130189939868,23,0.000251847796331782,91325,16,0.00019790223629527,80848,3.37606184976615
"matin",7,0.000668130189939868,23,0.000251847796331782,91325,16,0.00019790223629527,80848,3.37606184976615
"chief",3,0.000286341509974229,10,0.000109499041883384,91325,7,8.65822283791807e-05,80848,3.30716262834236
"méfait",3,0.000286341509974229,10,0.000109499041883384,91325,7,8.65822283791807e-05,80848,3.30716262834236
"moitié",3,0.000286341509974229,10,0.000109499041883384,91325,7,8.65822283791807e-05,80848,3.30716262834236
"palais",3,0.000286341509974229,10,0.000109499041883384,91325,7,8.65822283791807e-05,80848,3.30716262834236
"péchie",3,0.000286341509974229,10,0.000109499041883384,91325,7,8.65822283791807e-05,80848,3.30716262834236
"trembler",3,0.000286341509974229,10,0.000109499041883384,91325,7,8.65822283791807e-05,80848,3.30716262834236
"armer",9,0.000859024529922688,30,0.000328497125650151,91325,21,0.000259746685137542,80848,3.30716262834235
"conforter",5,0.000477235849957049,17,0.000186148371201752,91325,12,0.000148426677221453,80848,3.21529699977729
"courroucer",5,0.000477235849957049,17,0.000186148371201752,91325,12,0.000148426677221453,80848,3.21529699977729
"ferir",5,0.000477235849957049,17,0.000186148371201752,91325,12,0.000148426677221453,80848,3.21529699977729
"pechëor",5,0.000477235849957049,17,0.000186148371201752,91325,12,0.000148426677221453,80848,3.21529699977729
"requerre",5,0.000477235849957049,17,0.000186148371201752,91325,12,0.000148426677221453,80848,3.21529699977729
"gésir",7,0.000668130189939868,24,0.00026279770052012,91325,17,0.000210271126063725,80848,3.1774699762505
"laisser",25,0.00238617924978524,86,0.000941691760197098,91325,61,0.000754502275875717,80848,3.16258721289569
"donner",33,0.00314975660971652,114,0.00124828907747057,91325,81,0.00100188007124481,80848,3.14384595533779
"longuement",8,0.000763577359931278,28,0.000306597317273474,91325,20,0.000247377795369088,80848,3.0866851197862
"mer",8,0.000763577359931278,28,0.000306597317273474,91325,20,0.000247377795369088,80848,3.0866851197862
"nu",8,0.000763577359931278,28,0.000306597317273474,91325,20,0.000247377795369088,80848,3.0866851197862
"tirer",8,0.000763577359931278,28,0.000306597317273474,91325,20,0.000247377795369088,80848,3.0866851197862
"biere",4,0.000381788679965639,14,0.000153298658636737,91325,10,0.000123688897684544,80848,3.0866851197862
"penitence",4,0.000381788679965639,14,0.000153298658636737,91325,10,0.000123688897684544,80848,3.0866851197862
"souvenir",4,0.000381788679965639,14,0.000153298658636737,91325,10,0.000123688897684544,80848,3.0866851197862
"tüer",4,0.000381788679965639,14,0.000153298658636737,91325,10,0.000123688897684544,80848,3.0866851197862
"vin",4,0.000381788679965639,14,0.000153298658636737,91325,10,0.000123688897684544,80848,3.0866851197862
"tenir",37,0.00353154528968216,130,0.00142348754448399,91325,93,0.00115030674846626,80848,3.07009003849702
"öir",15,0.00143170754987115,53,0.000580344921981933,91325,38,0.000470017811201267,80848,3.04607084189428
"penser",13,0.00124081320988833,46,0.000503695592663564,91325,33,0.000408173362358995,80848,3.0399171634258
"requérir",11,0.00104991886990551,39,0.000427046263345196,91325,28,0.000346328913516723,80848,3.03156574264716
"jesir",10,0.000954471699914098,36,0.000394196550780181,91325,26,0.000321591133979814,80848,2.96796646133288
"conquerre",5,0.000477235849957049,18,0.00019709827539009,91325,13,0.000160795566989907,80848,2.96796646133288
"emporter",5,0.000477235849957049,18,0.00019709827539009,91325,13,0.000160795566989907,80848,2.96796646133288
"jurer",5,0.000477235849957049,18,0.00019709827539009,91325,13,0.000160795566989907,80848,2.96796646133288
"dur",6,0.000572683019948459,22,0.000240897892143444,91325,16,0.00019790223629527,80848,2.89376729979956
"häir",6,0.000572683019948459,22,0.000240897892143444,91325,16,0.00019790223629527,80848,2.89376729979956
"détruire",3,0.000286341509974229,11,0.000120448946071722,91325,8,9.89511181476351e-05,80848,2.89376729979956
"ermitage",3,0.000286341509974229,11,0.000120448946071722,91325,8,9.89511181476351e-05,80848,2.89376729979956
"lusure",3,0.000286341509974229,11,0.000120448946071722,91325,8,9.89511181476351e-05,80848,2.89376729979956
"prier",14,0.00133626037987974,52,0.000569395017793594,91325,38,0.000470017811201267,80848,2.84299945243466
"ariere",7,0.000668130189939868,26,0.000284697508896797,91325,19,0.000235008905600633,80848,2.84299945243466
"moutier",8,0.000763577359931278,30,0.000328497125650151,91325,22,0.000272115574905996,80848,2.80607738162382
"otroiier",4,0.000381788679965639,15,0.000164248562825075,91325,11,0.000136057787452998,80848,2.80607738162382
"Sans",4,0.000381788679965639,15,0.000164248562825075,91325,11,0.000136057787452998,80848,2.80607738162382
"vivre",13,0.00124081320988833,49,0.000536545305228579,91325,36,0.000445280031664358,80848,2.78659073314032
"tour",5,0.000477235849957049,19,0.000208048179578429,91325,14,0.000173164456758361,80848,2.75596885695196
"aller",52,0.00496325283955331,200,0.00218998083766767,91325,148,0.00183059568573125,80848,2.71127747008247
"traire",10,0.000954471699914098,39,0.000427046263345196,91325,29,0.000358697803285177,80848,2.66093544809155
"revenir",9,0.000859024529922688,36,0.000394196550780181,91325,27,0.000333960023748268,80848,2.57223759982183
"choir",5,0.000477235849957049,20,0.000218998083766767,91325,15,0.000185533346526816,80848,2.57223759982183
"non",14,0.00133626037987974,56,0.000613194634546948,91325,42,0.000519493370275084,80848,2.57223759982183
"hardi",6,0.000572683019948459,24,0.00026279770052012,91325,18,0.000222640015832179,80848,2.57223759982183
"boire",4,0.000381788679965639,16,0.000175198467013414,91325,12,0.000148426677221453,80848,2.57223759982183
"couvrir",4,0.000381788679965639,16,0.000175198467013414,91325,12,0.000148426677221453,80848,2.57223759982183
"veillier",4,0.000381788679965639,16,0.000175198467013414,91325,12,0.000148426677221453,80848,2.57223759982183
"briément",3,0.000286341509974229,12,0.00013139885026006,91325,9,0.000111320007916089,80848,2.57223759982183
"aler",60,0.00572683019948459,241,0.00263892690938954,91325,181,0.00223876904809024,80848,2.55802634236425
"quérir",9,0.000859024529922688,37,0.000405146454968519,91325,28,0.000346328913516723,80848,2.48037197125677
"peine",17,0.00162260188985397,70,0.000766493293183685,91325,53,0.000655551157728082,80848,2.47517203001723
"priier",16,0.00152715471986256,66,0.000722693676430331,91325,50,0.000618444488422719,80848,2.46934809582896
"trover",7,0.000668130189939868,29,0.000317547221461812,91325,22,0.000272115574905996,80848,2.45531770892084
"falir",12,0.00114536603989692,50,0.000547495209416918,91325,38,0.000470017811201267,80848,2.43685667351542
"courtois",5,0.000477235849957049,21,0.000229947987955105,91325,16,0.00019790223629527,80848,2.41147274983297
"retenir",5,0.000477235849957049,21,0.000229947987955105,91325,16,0.00019790223629527,80848,2.41147274983297
"servir",23,0.00219528490980242,97,0.00106214070626882,91325,74,0.000915297842865624,80848,2.39843776199603
"petit",13,0.00124081320988833,55,0.000602244730358609,91325,42,0.000519493370275084,80848,2.3885063426917
"assez",11,0.00104991886990551,47,0.000514645496851902,91325,36,0.000445280031664358,80848,2.35788446650335
"garder",26,0.00248162641977665,112,0.0012263892690939,91325,86,0.00106372452008708,80848,2.33295968355934
"douter",9,0.000859024529922688,39,0.000427046263345196,91325,30,0.000371066693053631,80848,2.31501383983965
"créance",3,0.000286341509974229,13,0.000142348754448399,91325,10,0.000123688897684544,80848,2.31501383983965
"environ",3,0.000286341509974229,13,0.000142348754448399,91325,10,0.000123688897684544,80848,2.31501383983965
"ire",3,0.000286341509974229,13,0.000142348754448399,91325,10,0.000123688897684544,80848,2.31501383983965
"laver",3,0.000286341509974229,13,0.000142348754448399,91325,10,0.000123688897684544,80848,2.31501383983965
"oster",3,0.000286341509974229,13,0.000142348754448399,91325,10,0.000123688897684544,80848,2.31501383983965
"rire",3,0.000286341509974229,13,0.000142348754448399,91325,10,0.000123688897684544,80848,2.31501383983965
"voir",43,0.00410422830963062,188,0.00205858198740761,91325,145,0.00179348901642589,80848,2.28840448535873
"cité",13,0.00124081320988833,57,0.000624144538735286,91325,44,0.000544231149811993,80848,2.27993787256935
"fin",13,0.00124081320988833,58,0.000635094442923624,91325,45,0.000556600039580447,80848,2.22927258651225
"oraison",12,0.00114536603989692,54,0.000591294826170271,91325,42,0.000519493370275084,80848,2.20477508556157
"repentir",4,0.000381788679965639,18,0.00019709827539009,91325,14,0.000173164456758361,80848,2.20477508556157
"sens",7,0.000668130189939868,32,0.000350396934026827,91325,25,0.00030922224421136,80848,2.16067958385034
"ici",5,0.000477235849957049,23,0.000251847796331782,91325,18,0.000222640015832179,80848,2.14353133318486
"tendrement",5,0.000477235849957049,23,0.000251847796331782,91325,18,0.000222640015832179,80848,2.14353133318486
"gent",30,0.00286341509974229,139,0.00152203668217903,91325,109,0.00134820898476153,80848,2.12386590810977
"part",12,0.00114536603989692,56,0.000613194634546948,91325,44,0.000544231149811993,80848,2.10455803621786
"demorer",3,0.000286341509974229,14,0.000153298658636737,91325,11,0.000136057787452998,80848,2.10455803621786
"dent",3,0.000286341509974229,14,0.000153298658636737,91325,11,0.000136057787452998,80848,2.10455803621786
"message",3,0.000286341509974229,14,0.000153298658636737,91325,11,0.000136057787452998,80848,2.10455803621786
"vieux",3,0.000286341509974229,14,0.000153298658636737,91325,11,0.000136057787452998,80848,2.10455803621786
"despit",7,0.000668130189939868,33,0.000361346838215166,91325,26,0.000321591133979814,80848,2.07757652293302
"paix",8,0.000763577359931278,38,0.000416096359156857,91325,30,0.000371066693053631,80848,2.05779007985747
"respondre",5,0.000477235849957049,24,0.00026279770052012,91325,19,0.000235008905600633,80848,2.03071389459618
"valoir",9,0.000859024529922688,44,0.000481795784286887,91325,35,0.000432911141895903,80848,1.98429757700541
"souvent",12,0.00114536603989692,59,0.000646044347111963,91325,47,0.000581337819117356,80848,1.97022454454438
"ouïr",36,0.00343609811969075,179,0.00196003284971257,91325,143,0.00176875123688898,80848,1.9426689565088
"fois",9,0.000859024529922688,45,0.000492745688475226,91325,36,0.000445280031664358,80848,1.92917819986637
"mieux",7,0.000668130189939868,35,0.000383246646591842,91325,28,0.000346328913516723,80848,1.92917819986637
"bas",5,0.000477235849957049,25,0.000273747604708459,91325,20,0.000247377795369088,80848,1.92917819986637
"autel",4,0.000381788679965639,20,0.000218998083766767,91325,16,0.00019790223629527,80848,1.92917819986637
"noir",4,0.000381788679965639,20,0.000218998083766767,91325,16,0.00019790223629527,80848,1.92917819986637
"aider",2,0.00019089433998282,10,0.000109499041883384,91325,8,9.89511181476351e-05,80848,1.92917819986637
"garir",2,0.00019089433998282,10,0.000109499041883384,91325,8,9.89511181476351e-05,80848,1.92917819986637
"porte",3,0.000286341509974229,15,0.000164248562825075,91325,12,0.000148426677221453,80848,1.92917819986637
"mourir",19,0.00181349622983679,97,0.00106214070626882,91325,78,0.000964773401939442,80848,1.87971209217749
"envoyer",6,0.000572683019948459,31,0.000339447029838489,91325,25,0.00030922224421136,80848,1.85201107187172
"fait",6,0.000572683019948459,31,0.000339447029838489,91325,25,0.00030922224421136,80848,1.85201107187172
"mettre",20,0.0019089433998282,105,0.00114973993977553,91325,85,0.00105135563031862,80848,1.815697129286
"merveille",4,0.000381788679965639,21,0.000229947987955105,91325,17,0.000210271126063725,80848,1.815697129286
"souffrir",16,0.00152715471986256,85,0.00093074185600876,91325,69,0.000853453394023352,80848,1.78938267813693
"conte",5,0.000477235849957049,27,0.000295647413085135,91325,22,0.000272115574905996,80848,1.75379836351489
"pain",7,0.000668130189939868,38,0.000416096359156857,91325,31,0.000383435582822086,80848,1.74248353536318
"honneur",6,0.000572683019948459,33,0.000361346838215166,91325,27,0.000333960023748268,80848,1.71482506654789
"montrer",6,0.000572683019948459,33,0.000361346838215166,91325,27,0.000333960023748268,80848,1.71482506654789
"ennemi",22,0.00209983773981101,121,0.00132493840678894,91325,99,0.00122452008707698,80848,1.71482506654789
"felon",4,0.000381788679965639,22,0.000240897892143444,91325,18,0.000222640015832179,80848,1.71482506654789
"doute",2,0.00019089433998282,11,0.000120448946071722,91325,9,0.000111320007916089,80848,1.71482506654789
"glouton",2,0.00019089433998282,11,0.000120448946071722,91325,9,0.000111320007916089,80848,1.71482506654789
"lai",2,0.00019089433998282,11,0.000120448946071722,91325,9,0.000111320007916089,80848,1.71482506654789
"Mercure",2,0.00019089433998282,11,0.000120448946071722,91325,9,0.000111320007916089,80848,1.71482506654789
"miséricorde",2,0.00019089433998282,11,0.000120448946071722,91325,9,0.000111320007916089,80848,1.71482506654789
"poindre",2,0.00019089433998282,11,0.000120448946071722,91325,9,0.000111320007916089,80848,1.71482506654789
"pomme",2,0.00019089433998282,11,0.000120448946071722,91325,9,0.000111320007916089,80848,1.71482506654789
"vent",2,0.00019089433998282,11,0.000120448946071722,91325,9,0.000111320007916089,80848,1.71482506654789
"enfant",32,0.00305430943972511,177,0.00193813304133589,91325,145,0.00179348901642589,80848,1.70299868677859
"nom",14,0.00133626037987974,78,0.000854092526690391,91325,64,0.00079160894518108,80848,1.68803092488308
"prendre",42,0.00400878113963921,236,0.00258417738844785,91325,194,0.00239956461508015,80848,1.67062854421418
"foi",10,0.000954471699914098,57,0.000624144538735286,91325,47,0.000581337819117356,80848,1.64185378712032
"chëoir",4,0.000381788679965639,23,0.000251847796331782,91325,19,0.000235008905600633,80848,1.62457111567695
"os",4,0.000381788679965639,23,0.000251847796331782,91325,19,0.000235008905600633,80848,1.62457111567695
"doucement",10,0.000954471699914098,58,0.000635094442923624,91325,48,0.00059370670888581,80848,1.60764849988864
"connaître",5,0.000477235849957049,29,0.000317547221461812,91325,24,0.000296853354442905,80848,1.60764849988864
"vëoir",48,0.00458146415958767,280,0.00306597317273474,91325,232,0.00286958242628142,80848,1.59656126885493
"main",14,0.00133626037987974,82,0.000897892143443745,91325,68,0.000841084504254898,80848,1.58873498812525
"savoir",55,0.00524959434952754,325,0.00355871886120996,91325,270,0.00333960023748268,80848,1.5719229776689
"répondre",11,0.00104991886990551,65,0.000711743772241993,91325,54,0.000667920047496537,80848,1.5719229776689
"voloir",17,0.00162260188985397,101,0.00110594032302217,91325,84,0.00103898674055017,80848,1.56171568560611
"bel",15,0.00143170754987115,90,0.000985491376950452,91325,75,0.000927666732634079,80848,1.5433425598931
"doner",7,0.000668130189939868,42,0.000459895975910211,91325,35,0.000432911141895903,80848,1.5433425598931
"pucelle",5,0.000477235849957049,30,0.000328497125650151,91325,25,0.00030922224421136,80848,1.5433425598931
"las",4,0.000381788679965639,24,0.00026279770052012,91325,20,0.000247377795369088,80848,1.5433425598931
"manger",4,0.000381788679965639,24,0.00026279770052012,91325,20,0.000247377795369088,80848,1.5433425598931
"combattre",2,0.00019089433998282,12,0.00013139885026006,91325,10,0.000123688897684544,80848,1.5433425598931
"Mahom",2,0.00019089433998282,12,0.00013139885026006,91325,10,0.000123688897684544,80848,1.5433425598931
"plaire",9,0.000859024529922688,55,0.000602244730358609,91325,46,0.000568968929348902,80848,1.50979163467803
"ci",13,0.00124081320988833,80,0.000875992335067068,91325,67,0.000828715614486444,80848,1.49727263273211
"an",11,0.00104991886990551,68,0.000744593484807008,91325,57,0.0007050267168019,80848,1.48919018937053
"glorieux",5,0.000477235849957049,31,0.000339447029838489,91325,26,0.000321591133979814,80848,1.48398323066644
"chevalier",14,0.00133626037987974,88,0.000963591568573775,91325,74,0.000915297842865624,80848,1.45991863773672
"esprit",3,0.000286341509974229,19,0.000208048179578429,91325,16,0.00019790223629527,80848,1.44688364989978
"gré",5,0.000477235849957049,32,0.000350396934026827,91325,27,0.000333960023748268,80848,1.42902088878991
"lit",5,0.000477235849957049,32,0.000350396934026827,91325,27,0.000333960023748268,80848,1.42902088878991
"Alexis",9,0.000859024529922688,58,0.000635094442923624,91325,49,0.000606075598654265,80848,1.41735541214672
"boivre",2,0.00019089433998282,13,0.000142348754448399,91325,11,0.000136057787452998,80848,1.40303869081191
"ça",2,0.00019089433998282,13,0.000142348754448399,91325,11,0.000136057787452998,80848,1.40303869081191
"compagnon",2,0.00019089433998282,13,0.000142348754448399,91325,11,0.000136057787452998,80848,1.40303869081191
"mos",2,0.00019089433998282,13,0.000142348754448399,91325,11,0.000136057787452998,80848,1.40303869081191
"soir",2,0.00019089433998282,13,0.000142348754448399,91325,11,0.000136057787452998,80848,1.40303869081191
"user",2,0.00019089433998282,13,0.000142348754448399,91325,11,0.000136057787452998,80848,1.40303869081191
"rien",15,0.00143170754987115,98,0.00107309061045716,91325,83,0.00102661785078171,80848,1.39458665050581
"garde",3,0.000286341509974229,20,0.000218998083766767,91325,17,0.000210271126063725,80848,1.3617728469645
"maistre",3,0.000286341509974229,20,0.000218998083766767,91325,17,0.000210271126063725,80848,1.3617728469645
"joie",15,0.00143170754987115,101,0.00110594032302217,91325,86,0.00106372452008708,80848,1.34593827897654
"pié",5,0.000477235849957049,34,0.000372296742403504,91325,29,0.000358697803285177,80848,1.33046772404577
"croire",19,0.00181349622983679,133,0.001456337257049,91325,114,0.0014100534336038,80848,1.28611879991092
"pro",5,0.000477235849957049,35,0.000383246646591842,91325,30,0.000371066693053631,80848,1.28611879991092
"bois",6,0.000572683019948459,42,0.000459895975910211,91325,36,0.000445280031664358,80848,1.28611879991092
"marchéant",4,0.000381788679965639,28,0.000306597317273474,91325,24,0.000296853354442905,80848,1.28611879991092
"pechié",4,0.000381788679965639,28,0.000306597317273474,91325,24,0.000296853354442905,80848,1.28611879991092
"Sarrasin",4,0.000381788679965639,28,0.000306597317273474,91325,24,0.000296853354442905,80848,1.28611879991092
"essil",2,0.00019089433998282,14,0.000153298658636737,91325,12,0.000148426677221453,80848,1.28611879991092
"gros",2,0.00019089433998282,14,0.000153298658636737,91325,12,0.000148426677221453,80848,1.28611879991092
"devoir",23,0.00219528490980242,162,0.00177388447851081,91325,139,0.00171927567781516,80848,1.27686614667415
"péché",6,0.000572683019948459,43,0.000470845880098549,91325,37,0.000457648921432812,80848,1.25135883234576
"là",15,0.00143170754987115,108,0.00118258965234054,91325,93,0.00115030674846626,80848,1.24463109668798
"amor",5,0.000477235849957049,36,0.000394196550780181,91325,31,0.000383435582822086,80848,1.24463109668798
"cheval",5,0.000477235849957049,36,0.000394196550780181,91325,31,0.000383435582822086,80848,1.24463109668798
"convenir",5,0.000477235849957049,36,0.000394196550780181,91325,31,0.000383435582822086,80848,1.24463109668798
"fol",4,0.000381788679965639,29,0.000317547221461812,91325,25,0.00030922224421136,80848,1.23467404791448
"mere",15,0.00143170754987115,109,0.00119353955652888,91325,94,0.00116267563823471,80848,1.23139034034024
"fortement",13,0.00124081320988833,95,0.00104024089789214,91325,82,0.00101424896101326,80848,1.22338129747624
"gloire",3,0.000286341509974229,22,0.000240897892143444,91325,19,0.000235008905600633,80848,1.21842833675771
"honte",3,0.000286341509974229,22,0.000240897892143444,91325,19,0.000235008905600633,80848,1.21842833675771
"grand",9,0.000859024529922688,67,0.00073364358061867,91325,58,0.000717395606570354,80848,1.1974209516412
"plaie",2,0.00019089433998282,15,0.000164248562825075,91325,13,0.000160795566989907,80848,1.18718658453315
"ainsi",15,0.00143170754987115,114,0.00124828907747057,91325,99,0.00122452008707698,80848,1.16919890900992
"chien",8,0.000763577359931278,61,0.00066794415548864,91325,53,0.000655551157728082,80848,1.16478683765517
"cuidier",9,0.000859024529922688,69,0.000755543388995346,91325,60,0.000742133386107263,80848,1.15750691991982
"oser",3,0.000286341509974229,23,0.000251847796331782,91325,20,0.000247377795369088,80848,1.15750691991982
"premier",4,0.000381788679965639,31,0.000339447029838489,91325,27,0.000333960023748268,80848,1.14321671103193
"ja",12,0.00114536603989692,93,0.00101834108951547,91325,81,0.00100188007124481,80848,1.14321671103193
"fors",9,0.000859024529922688,71,0.000777443197372023,91325,62,0.000766871165644172,80848,1.12016798701918
"moi",14,0.00133626037987974,111,0.00121543936490556,91325,97,0.00119978230754008,80848,1.11375236280945
"venir",51,0.0048678056695619,405,0.00443471119627703,91325,354,0.00437858697803285,80848,1.11172981009249
"anel",2,0.00019089433998282,16,0.000175198467013414,91325,14,0.000173164456758361,80848,1.10238754278078
"cher",2,0.00019089433998282,16,0.000175198467013414,91325,14,0.000173164456758361,80848,1.10238754278078
"fruit",2,0.00019089433998282,16,0.000175198467013414,91325,14,0.000173164456758361,80848,1.10238754278078
"poi",2,0.00019089433998282,16,0.000175198467013414,91325,14,0.000173164456758361,80848,1.10238754278078
"monde",11,0.00104991886990551,89,0.000974541472762113,91325,78,0.000964773401939442,80848,1.08825436915539
"amour",8,0.000763577359931278,65,0.000711743772241993,91325,57,0.0007050267168019,80848,1.0830474104513
"pouvoir",22,0.00209983773981101,184,0.00201478237065426,91325,162,0.00200376014248961,80848,1.04794865177926
"maintenant",2,0.00019089433998282,17,0.000186148371201752,91325,15,0.000185533346526816,80848,1.02889503992873
"quoi",6,0.000572683019948459,51,0.000558445113605256,91325,45,0.000556600039580447,80848,1.02889503992873
"chrétien",4,0.000381788679965639,35,0.000383246646591842,91325,31,0.000383435582822086,80848,0.995704877350386
"mauvais",6,0.000572683019948459,53,0.000580344921981933,91325,47,0.000581337819117356,80848,0.985112272272191
"terre",12,0.00114536603989692,107,0.0011716397481522,91325,95,0.00117504452800317,80848,0.974742669406168
"faus",2,0.00019089433998282,18,0.00019709827539009,91325,16,0.00019790223629527,80848,0.964589099933187
"faux",2,0.00019089433998282,18,0.00019709827539009,91325,16,0.00019790223629527,80848,0.964589099933187
"lance",2,0.00019089433998282,18,0.00019709827539009,91325,16,0.00019790223629527,80848,0.964589099933187
"comment",11,0.00104991886990551,100,0.00109499041883384,91325,89,0.00110083118939244,80848,0.953751020158657
"fort",10,0.000954471699914098,91,0.00099644128113879,91325,81,0.00100188007124481,80848,0.952680592526604
"faire",122,0.011644554738952,1112,0.0121762934574322,91325,990,0.0122452008707698,80848,0.950948445994738
"mort",8,0.000763577359931278,73,0.0007993430057487,91325,65,0.000803977834949535,80848,0.949749267626522
"ame",8,0.000763577359931278,74,0.000810292909937038,91325,66,0.000816346724717989,80848,0.935359127207939
"Jésus-Christ",8,0.000763577359931278,74,0.000810292909937038,91325,66,0.000816346724717989,80848,0.935359127207939
"œil",3,0.000286341509974229,28,0.000306597317273474,91325,25,0.00030922224421136,80848,0.92600553593586
"point",9,0.000859024529922688,85,0.00093074185600876,91325,76,0.000940035622402533,80848,0.913821252568282
"degré",2,0.00019089433998282,19,0.000208048179578429,91325,17,0.000210271126063725,80848,0.907848564642999
"seneschal",2,0.00019089433998282,19,0.000208048179578429,91325,17,0.000210271126063725,80848,0.907848564642999
"uis",2,0.00019089433998282,19,0.000208048179578429,91325,17,0.000210271126063725,80848,0.907848564642999
"commencer",5,0.000477235849957049,48,0.000525595401040241,91325,43,0.000531862260043538,80848,0.89729218598436
"pöoir",16,0.00152715471986256,158,0.00173008486175746,91325,142,0.00175638234712052,80848,0.869488766136957
"sergent",3,0.000286341509974229,30,0.000328497125650151,91325,27,0.000333960023748268,80848,0.857412533273944
"droit",11,0.00104991886990551,110,0.00120448946071722,91325,99,0.00122452008707698,80848,0.857412533273944
"enfer",8,0.000763577359931278,80,0.000875992335067068,91325,72,0.000890560063328716,80848,0.857412533273944
"église",7,0.000668130189939868,70,0.000766493293183685,91325,63,0.000779240055412626,80848,0.857412533273944
"croix",5,0.000477235849957049,50,0.000547495209416918,91325,45,0.000556600039580447,80848,0.857412533273944
"pucele",4,0.000381788679965639,40,0.000437996167533534,91325,36,0.000445280031664358,80848,0.857412533273944
"larron",2,0.00019089433998282,20,0.000218998083766767,91325,18,0.000222640015832179,80848,0.857412533273944
"personne",2,0.00019089433998282,20,0.000218998083766767,91325,18,0.000222640015832179,80848,0.857412533273944
"beste",1,9.54471699914098e-05,10,0.000109499041883384,91325,9,0.000111320007916089,80848,0.857412533273944
"cheminer",1,9.54471699914098e-05,10,0.000109499041883384,91325,9,0.000111320007916089,80848,0.857412533273944
"dessous",1,9.54471699914098e-05,10,0.000109499041883384,91325,9,0.000111320007916089,80848,0.857412533273944
"hôtel",1,9.54471699914098e-05,10,0.000109499041883384,91325,9,0.000111320007916089,80848,0.857412533273944
"idole",1,9.54471699914098e-05,10,0.000109499041883384,91325,9,0.000111320007916089,80848,0.857412533273944
"Odon",1,9.54471699914098e-05,10,0.000109499041883384,91325,9,0.000111320007916089,80848,0.857412533273944
"peur",1,9.54471699914098e-05,10,0.000109499041883384,91325,9,0.000111320007916089,80848,0.857412533273944
"quite",1,9.54471699914098e-05,10,0.000109499041883384,91325,9,0.000111320007916089,80848,0.857412533273944
"Rebebus",1,9.54471699914098e-05,10,0.000109499041883384,91325,9,0.000111320007916089,80848,0.857412533273944
"sofrir",1,9.54471699914098e-05,10,0.000109499041883384,91325,9,0.000111320007916089,80848,0.857412533273944
"table",1,9.54471699914098e-05,10,0.000109499041883384,91325,9,0.000111320007916089,80848,0.857412533273944
"sien",4,0.000381788679965639,41,0.000448946071721872,91325,37,0.000457648921432812,80848,0.834239221563837
"dire",97,0.00925837548916675,997,0.0109170544757733,91325,900,0.0111320007916089,80848,0.831690157275726
"ciel",7,0.000668130189939868,72,0.000788393101560361,91325,65,0.000803977834949535,80848,0.831030609173207
"Jésus",13,0.00124081320988833,134,0.00146728716123734,91325,121,0.00149663566198298,80848,0.829068317297946
"genou",2,0.00019089433998282,21,0.000229947987955105,91325,19,0.000235008905600633,80848,0.812285557838473
"courir",3,0.000286341509974229,32,0.000350396934026827,91325,29,0.000358697803285177,80848,0.798280634427465
"reine",4,0.000381788679965639,43,0.000470845880098549,91325,39,0.000482386700969721,80848,0.791457723022102
"jour",15,0.00143170754987115,162,0.00177388447851081,91325,147,0.00181822679596279,80848,0.787419673414847
"escuier",1,9.54471699914098e-05,11,0.000120448946071722,91325,10,0.000123688897684544,80848,0.77167127994655
"Julien",1,9.54471699914098e-05,11,0.000120448946071722,91325,10,0.000123688897684544,80848,0.77167127994655
"penance",1,9.54471699914098e-05,11,0.000120448946071722,91325,10,0.000123688897684544,80848,0.77167127994655
"port",1,9.54471699914098e-05,11,0.000120448946071722,91325,10,0.000123688897684544,80848,0.77167127994655
"juif",2,0.00019089433998282,23,0.000251847796331782,91325,21,0.000259746685137542,80848,0.734925028520523
"païen",2,0.00019089433998282,23,0.000251847796331782,91325,21,0.000259746685137542,80848,0.734925028520523
"pied",2,0.00019089433998282,23,0.000251847796331782,91325,21,0.000259746685137542,80848,0.734925028520523
"lieu",7,0.000668130189939868,81,0.000886942239255407,91325,74,0.000915297842865624,80848,0.729959318868358
"parole",3,0.000286341509974229,36,0.000394196550780181,91325,33,0.000408173362358995,80848,0.701519345405954
"vrai",3,0.000286341509974229,36,0.000394196550780181,91325,33,0.000408173362358995,80848,0.701519345405954
"encontre",2,0.00019089433998282,24,0.00026279770052012,91325,22,0.000272115574905996,80848,0.701519345405954
"Basilles",1,9.54471699914098e-05,12,0.00013139885026006,91325,11,0.000136057787452998,80848,0.701519345405954
"bataille",1,9.54471699914098e-05,12,0.00013139885026006,91325,11,0.000136057787452998,80848,0.701519345405954
"chapelle",1,9.54471699914098e-05,12,0.00013139885026006,91325,11,0.000136057787452998,80848,0.701519345405954
"cuisse",1,9.54471699914098e-05,12,0.00013139885026006,91325,11,0.000136057787452998,80848,0.701519345405954
"jadis",1,9.54471699914098e-05,12,0.00013139885026006,91325,11,0.000136057787452998,80848,0.701519345405954
"justice",1,9.54471699914098e-05,12,0.00013139885026006,91325,11,0.000136057787452998,80848,0.701519345405954
"oeil",1,9.54471699914098e-05,12,0.00013139885026006,91325,11,0.000136057787452998,80848,0.701519345405954
"seoir",1,9.54471699914098e-05,12,0.00013139885026006,91325,11,0.000136057787452998,80848,0.701519345405954
"frère",4,0.000381788679965639,49,0.000536545305228579,91325,45,0.000556600039580447,80848,0.685930026619155
"loi",2,0.00019089433998282,25,0.000273747604708459,91325,23,0.000284484464674451,80848,0.671018504301347
"vouloir",28,0.00267252075975947,351,0.00384341637010676,91325,323,0.00399515139521077,80848,0.668941047631684
"fils",4,0.000381788679965639,51,0.000558445113605256,91325,47,0.000581337819117356,80848,0.656741514848127
"hors",3,0.000286341509974229,39,0.000427046263345196,91325,36,0.000445280031664358,80848,0.643059399955458
"li",3,0.000286341509974229,39,0.000427046263345196,91325,36,0.000445280031664358,80848,0.643059399955458
"âme",2,0.00019089433998282,26,0.000284697508896797,91325,24,0.000296853354442905,80848,0.643059399955458
"franc",2,0.00019089433998282,26,0.000284697508896797,91325,24,0.000296853354442905,80848,0.643059399955458
"chatel",1,9.54471699914098e-05,13,0.000142348754448399,91325,12,0.000148426677221453,80848,0.643059399955458
"cote",1,9.54471699914098e-05,13,0.000142348754448399,91325,12,0.000148426677221453,80848,0.643059399955458
"face",1,9.54471699914098e-05,13,0.000142348754448399,91325,12,0.000148426677221453,80848,0.643059399955458
"moins",1,9.54471699914098e-05,13,0.000142348754448399,91325,12,0.000148426677221453,80848,0.643059399955458
"pan",1,9.54471699914098e-05,13,0.000142348754448399,91325,12,0.000148426677221453,80848,0.643059399955458
"père",15,0.00143170754987115,197,0.00215713112510266,91325,182,0.0022511379378587,80848,0.635992813142761
"chose",5,0.000477235849957049,66,0.000722693676430331,91325,61,0.000754502275875717,80848,0.632517442579139
"advenir",2,0.00019089433998282,27,0.000295647413085135,91325,25,0.00030922224421136,80848,0.61733702395724
"oeuvre",2,0.00019089433998282,27,0.000295647413085135,91325,25,0.00030922224421136,80848,0.61733702395724
"Christ",5,0.000477235849957049,68,0.000744593484807008,91325,63,0.000779240055412626,80848,0.612437523767103
"jor",3,0.000286341509974229,42,0.000459895975910211,91325,39,0.000482386700969721,80848,0.593593292266577
"tyran",3,0.000286341509974229,42,0.000459895975910211,91325,39,0.000482386700969721,80848,0.593593292266577
"ainçois",1,9.54471699914098e-05,14,0.000153298658636737,91325,13,0.000160795566989907,80848,0.593593292266577
"fief",1,9.54471699914098e-05,14,0.000153298658636737,91325,13,0.000160795566989907,80848,0.593593292266577
"jardin",1,9.54471699914098e-05,14,0.000153298658636737,91325,13,0.000160795566989907,80848,0.593593292266577
"seror",1,9.54471699914098e-05,14,0.000153298658636737,91325,13,0.000160795566989907,80848,0.593593292266577
"set",1,9.54471699914098e-05,14,0.000153298658636737,91325,13,0.000160795566989907,80848,0.593593292266577
"mot",3,0.000286341509974229,43,0.000470845880098549,91325,40,0.000494755590738175,80848,0.578753459959912
"femme",5,0.000477235849957049,72,0.000788393101560361,91325,67,0.000828715614486444,80848,0.57587408951235
"heure",4,0.000381788679965639,58,0.000635094442923624,91325,54,0.000667920047496537,80848,0.571608355515963
"avoir",133,0.0126944736088575,1960,0.0214618122091432,91325,1827,0.0225979616069662,80848,0.561753039041549
"mortel",2,0.00019089433998282,30,0.000328497125650151,91325,28,0.000346328913516723,80848,0.551193771390392
"dix",1,9.54471699914098e-05,15,0.000164248562825075,91325,14,0.000173164456758361,80848,0.551193771390392
"mi",1,9.54471699914098e-05,15,0.000164248562825075,91325,14,0.000173164456758361,80848,0.551193771390392
"Rouen",1,9.54471699914098e-05,15,0.000164248562825075,91325,14,0.000173164456758361,80848,0.551193771390392
"suivre",1,9.54471699914098e-05,15,0.000164248562825075,91325,14,0.000173164456758361,80848,0.551193771390392
"fil",5,0.000477235849957049,77,0.000843142622502053,91325,72,0.000890560063328716,80848,0.535882833296215
"issi",3,0.000286341509974229,47,0.000514645496851902,91325,44,0.000544231149811993,80848,0.526139509054466
"mal",10,0.000954471699914098,157,0.00171913495756912,91325,147,0.00181822679596279,80848,0.524946448943231
"ensemble",2,0.00019089433998282,32,0.000350396934026827,91325,30,0.000371066693053631,80848,0.514447519964366
"catre",1,9.54471699914098e-05,16,0.000175198467013414,91325,15,0.000185533346526816,80848,0.514447519964366
"deuil",1,9.54471699914098e-05,16,0.000175198467013414,91325,15,0.000185533346526816,80848,0.514447519964366
"endroit",1,9.54471699914098e-05,16,0.000175198467013414,91325,15,0.000185533346526816,80848,0.514447519964366
"gentil",1,9.54471699914098e-05,16,0.000175198467013414,91325,15,0.000185533346526816,80848,0.514447519964366
"nuit",4,0.000381788679965639,65,0.000711743772241993,91325,61,0.000754502275875717,80848,0.506013954063311
"prudhomme",4,0.000381788679965639,65,0.000711743772241993,91325,61,0.000754502275875717,80848,0.506013954063311
"sain",3,0.000286341509974229,49,0.000536545305228579,91325,46,0.000568968929348902,80848,0.503263878226011
"force",2,0.00019089433998282,33,0.000361346838215166,91325,31,0.000383435582822086,80848,0.497852438675193
"Jehan",2,0.00019089433998282,34,0.000372296742403504,91325,32,0.00039580447259054,80848,0.482294549966593
"Burgifier",1,9.54471699914098e-05,17,0.000186148371201752,91325,16,0.00019790223629527,80848,0.482294549966593
"fosse",1,9.54471699914098e-05,17,0.000186148371201752,91325,16,0.00019790223629527,80848,0.482294549966593
"fou",1,9.54471699914098e-05,17,0.000186148371201752,91325,16,0.00019790223629527,80848,0.482294549966593
"ostel",1,9.54471699914098e-05,17,0.000186148371201752,91325,16,0.00019790223629527,80848,0.482294549966593
"sanc",1,9.54471699914098e-05,17,0.000186148371201752,91325,16,0.00019790223629527,80848,0.482294549966593
"seignor",12,0.00114536603989692,204,0.00223378045442102,91325,192,0.00237482683554324,80848,0.482294549966593
"gens",5,0.000477235849957049,86,0.000941691760197098,91325,81,0.00100188007124481,80848,0.476340296263302
"corps",15,0.00143170754987115,265,0.00290172460990966,91325,250,0.0030922224421136,80848,0.46300276796793
"être",28,0.00267252075975947,500,0.00547495209416918,91325,472,0.00583811597071047,80848,0.457771098273377
"lonc",1,9.54471699914098e-05,18,0.00019709827539009,91325,17,0.000210271126063725,80848,0.4539242823215
"ui",1,9.54471699914098e-05,18,0.00019709827539009,91325,17,0.000210271126063725,80848,0.4539242823215
"mille",2,0.00019089433998282,37,0.000405146454968519,91325,35,0.000432911141895903,80848,0.440955017112314
"voix",3,0.000286341509974229,57,0.000624144538735286,91325,54,0.000667920047496537,80848,0.428706266636972
"adès",1,9.54471699914098e-05,19,0.000208048179578429,91325,18,0.000222640015832179,80848,0.428706266636972
"roi",21,0.0020043905698196,403,0.00441281138790036,91325,382,0.00472491589154957,80848,0.424217195782135
"homme",12,0.00114536603989692,231,0.00252942786750616,91325,219,0.00270878685929151,80848,0.422833578052904
"maître",1,9.54471699914098e-05,20,0.000218998083766767,91325,19,0.000235008905600633,80848,0.406142778919237
"temps",3,0.000286341509974229,64,0.000700793868053655,91325,61,0.000754502275875717,80848,0.379510465547483
"jamais",2,0.00019089433998282,44,0.000481795784286887,91325,42,0.000519493370275084,80848,0.367462514260262
"archevêque",1,9.54471699914098e-05,22,0.000240897892143444,91325,21,0.000259746685137542,80848,0.367462514260262
"digne",1,9.54471699914098e-05,22,0.000240897892143444,91325,21,0.000259746685137542,80848,0.367462514260262
"entour",1,9.54471699914098e-05,22,0.000240897892143444,91325,21,0.000259746685137542,80848,0.367462514260262
"près",1,9.54471699914098e-05,22,0.000240897892143444,91325,21,0.000259746685137542,80848,0.367462514260262
"estre",99,0.00944926982914957,2274,0.0249000821242814,91325,2175,0.0269023352463883,80848,0.351243479148085
"chétif",1,9.54471699914098e-05,23,0.000251847796331782,91325,22,0.000272115574905996,80848,0.350759672702977
"nef",1,9.54471699914098e-05,23,0.000251847796331782,91325,22,0.000272115574905996,80848,0.350759672702977
"nie",1,9.54471699914098e-05,23,0.000251847796331782,91325,22,0.000272115574905996,80848,0.350759672702977
"tant",14,0.00133626037987974,323,0.00353681905283329,91325,309,0.0038219869384524,80848,0.349624528131123
"sus",3,0.000286341509974229,70,0.000766493293183685,91325,67,0.000828715614486444,80848,0.34552445370741
"entre",2,0.00019089433998282,47,0.000514645496851902,91325,45,0.000556600039580447,80848,0.342965013309578
"grâce",2,0.00019089433998282,49,0.000536545305228579,91325,47,0.000581337819117356,80848,0.328370757424064
"lors",9,0.000859024529922688,224,0.00245277853818779,91325,215,0.00265931130021769,80848,0.32302518695437
"beau",4,0.000381788679965639,101,0.00110594032302217,91325,97,0.00119978230754008,80848,0.318214960802701
"dedans",3,0.000286341509974229,76,0.000832192718313715,91325,73,0.00090292895309717,80848,0.317125183539678
"aussi",2,0.00019089433998282,51,0.000558445113605256,91325,49,0.000606075598654265,80848,0.314967869365939
"Michel",1,9.54471699914098e-05,26,0.000284697508896797,91325,25,0.00030922224421136,80848,0.30866851197862
"Sébastien",1,9.54471699914098e-05,26,0.000284697508896797,91325,25,0.00030922224421136,80848,0.30866851197862
"tous",10,0.000954471699914098,265,0.00290172460990966,91325,255,0.00315406689095587,80848,0.302616188214333
"conseil",1,9.54471699914098e-05,27,0.000295647413085135,91325,26,0.000321591133979814,80848,0.296796646133288
"trèstous",1,9.54471699914098e-05,27,0.000295647413085135,91325,26,0.000321591133979814,80848,0.296796646133288
"doux",4,0.000381788679965639,109,0.00119353955652888,91325,105,0.00129873342568771,80848,0.293970011408209
"bon",11,0.00104991886990551,300,0.00328497125650151,91325,289,0.00357460914308332,80848,0.293715712090382
"pas",6,0.000572683019948459,164,0.00179578428688749,91325,158,0.00195428458341579,80848,0.293039726561981
"diable",4,0.000381788679965639,111,0.00121543936490556,91325,107,0.00132347120522462,80848,0.288475244839832
"évêque",1,9.54471699914098e-05,28,0.000306597317273474,91325,27,0.000333960023748268,80848,0.285804177757981
"plusieurs",1,9.54471699914098e-05,28,0.000306597317273474,91325,27,0.000333960023748268,80848,0.285804177757981
"sembler",1,9.54471699914098e-05,28,0.000306597317273474,91325,27,0.000333960023748268,80848,0.285804177757981
"nul",7,0.000668130189939868,196,0.00214618122091432,91325,189,0.00233772016623788,80848,0.285804177757981
"deux",5,0.000477235849957049,142,0.00155488639474405,91325,137,0.00169453789827825,80848,0.281631853995091
"grant",18,0.00171804905984538,545,0.0059676977826444,91325,527,0.00651840490797546,80848,0.263568938122161
"ermite",2,0.00019089433998282,61,0.00066794415548864,91325,59,0.000729764496338809,80848,0.261583484727644
"haut",3,0.000286341509974229,92,0.00100739118532713,91325,89,0.00110083118939244,80848,0.260113914588725
"Angleterre",1,9.54471699914098e-05,31,0.000339447029838489,91325,30,0.000371066693053631,80848,0.257223759982183
"eux",2,0.00019089433998282,65,0.000711743772241993,91325,63,0.000779240055412626,80848,0.244975009506841
"fer",1,9.54471699914098e-05,33,0.000361346838215166,91325,32,0.00039580447259054,80848,0.241147274983297
"trois",2,0.00019089433998282,67,0.00073364358061867,91325,65,0.000803977834949535,80848,0.237437316906631
"forest",1,9.54471699914098e-05,34,0.000372296742403504,91325,33,0.000408173362358995,80848,0.233839781801985
"cel",5,0.000477235849957049,172,0.0018833835203942,91325,167,0.00206560459133188,80848,0.231039305373218
"tel",4,0.000381788679965639,148,0.00162058581987408,91325,144,0.00178112012665743,80848,0.214353133318486
"blanc",1,9.54471699914098e-05,37,0.000405146454968519,91325,36,0.000445280031664358,80848,0.214353133318486
"dame",4,0.000381788679965639,156,0.00170818505338078,91325,152,0.00188007124480507,80848,0.203071389459618
"cent",1,9.54471699914098e-05,39,0.000427046263345196,91325,38,0.000470017811201267,80848,0.203071389459618
"Richard",3,0.000286341509974229,124,0.00135778811935396,91325,121,0.00149663566198298,80848,0.191323457837987
"Robert",3,0.000286341509974229,124,0.00135778811935396,91325,121,0.00149663566198298,80848,0.191323457837987
"devant",3,0.000286341509974229,125,0.00136873802354229,91325,122,0.00150900455175143,80848,0.189755232773742
"bien",13,0.00124081320988833,547,0.00598959759102108,91325,534,0.00660498713635464,80848,0.18786004942519
"seigneur",2,0.00019089433998282,85,0.00093074185600876,91325,83,0.00102661785078171,80848,0.185944886734108
"cuer",4,0.000381788679965639,171,0.00187243361620586,91325,167,0.00206560459133188,80848,0.184831444298575
"sur",2,0.00019089433998282,86,0.000941691760197098,91325,84,0.00103898674055017,80848,0.183731257130131
"Paul",1,9.54471699914098e-05,43,0.000470845880098549,91325,42,0.000519493370275084,80848,0.183731257130131
"on",5,0.000477235849957049,222,0.00243087872981111,91325,217,0.0026840490797546,80848,0.177804442383998
"feme",1,9.54471699914098e-05,45,0.000492745688475226,91325,44,0.000544231149811993,80848,0.175379836351489
"feu",1,9.54471699914098e-05,45,0.000492745688475226,91325,44,0.000544231149811993,80848,0.175379836351489
"tu",9,0.000859024529922688,416,0.00455516014234875,91325,407,0.00503413813576093,80848,0.170639840774421
"nous",3,0.000286341509974229,142,0.00155488639474405,91325,139,0.00171927567781516,80848,0.166547758261845
"lui",4,0.000381788679965639,204,0.00223378045442102,91325,200,0.00247377795369088,80848,0.15433425598931
"cest",3,0.000286341509974229,155,0.00169723514919244,91325,152,0.00188007124480507,80848,0.152303542094714
"nos",1,9.54471699914098e-05,55,0.000602244730358609,91325,54,0.000667920047496537,80848,0.142902088878991
"Rome",1,9.54471699914098e-05,57,0.000624144538735286,91325,56,0.000692657827033445,80848,0.137798442847598
"dieu",2,0.00019089433998282,115,0.00125923898165891,91325,113,0.00139768454383535,80848,0.136578987601159
"mon",7,0.000668130189939868,410,0.00448946071721872,91325,403,0.00498466257668712,80848,0.134037195027937
"Dieu",9,0.000859024529922688,571,0.0062523952915412,91325,562,0.00695131604987136,80848,0.123577251236992
"vers",1,9.54471699914098e-05,67,0.00073364358061867,91325,66,0.000816346724717989,80848,0.116919890900992
"ton",2,0.00019089433998282,162,0.00177388447851081,91325,160,0.0019790223629527,80848,0.0964589099933187
"tost",1,9.54471699914098e-05,83,0.000908842047632083,91325,82,0.00101424896101326,80848,0.0941062536520182
"duc",1,9.54471699914098e-05,89,0.000974541472762113,91325,88,0.00108846229962399,80848,0.0876899181757443
"or",2,0.00019089433998282,196,0.00214618122091432,91325,194,0.00239956461508015,80848,0.0795537402006752
"maint",1,9.54471699914098e-05,115,0.00125923898165891,91325,114,0.0014100534336038,80848,0.0676904631532061
"elle",1,9.54471699914098e-05,127,0.00139063783191897,91325,126,0.00155848011082525,80848,0.0612437523767103
"vous",5,0.000477235849957049,635,0.00695318915959485,91325,630,0.00779240055412626,80848,0.0612437523767103
"saint",5,0.000477235849957049,667,0.00730358609362168,91325,662,0.0081882050267168,80848,0.0582833293010989
"soi",6,0.000572683019948459,869,0.00951546673966603,91325,863,0.0106743518701761,80848,0.0536503786753105
"moult",2,0.00019089433998282,306,0.00335067068163154,91325,304,0.00376014248961013,80848,0.0507678473649046
"tot",1,9.54471699914098e-05,155,0.00169723514919244,91325,154,0.00190480902434197,80848,0.0501085246718539
"a",12,0.00114536603989692,2037,0.0223049548316452,91325,2025,0.0250470017811201,80848,0.045728668441277
"pour",3,0.000286341509974229,582,0.00637284423761292,91325,579,0.00716158717593509,80848,0.0399829678728782
"tout",2,0.00019089433998282,410,0.00448946071721872,91325,408,0.00504650702552939,80848,0.0378270235267916
"cant",1,9.54471699914098e-05,220,0.00240897892143444,91325,219,0.00270878685929151,80848,0.0352361315044087
"mais",2,0.00019089433998282,461,0.00504790583082398,91325,459,0.00567732040372056,80848,0.0336240209127037
"plus",1,9.54471699914098e-05,234,0.00256227758007117,91325,233,0.00288195131604987,80848,0.0331189390535
"je",5,0.000477235849957049,1175,0.0128661374212976,91325,1170,0.0144716010290916,80848,0.0329774051259209
"cil",1,9.54471699914098e-05,237,0.00259512729263619,91325,236,0.00291905798535523,80848,0.0326979355909555
"il",13,0.00124081320988833,3196,0.0349958937859294,91325,3183,0.0393701761329903,80848,0.0315165775661487
"son",4,0.000381788679965639,1414,0.0154831645223104,91325,1410,0.0174401345735207,80848,0.0218913838282709
"un",2,0.00019089433998282,892,0.00976731453599781,91325,890,0.0110083118939244,80848,0.0173409276392483
"de",3,0.000286341509974229,2809,0.0307582808650424,91325,2806,0.034707104690283,80848,0.00825022751190181
"le",2,0.00019089433998282,5039,0.055176567205037,91325,5037,0.0623020977637047,80848,0.00306401143516597
